Name,Points,Unnamed: 1_level_0Age,Unnamed: 4_level_0No.,GamesG,GamesGS,RushingRush,RushingYds,RushingTD,Rushing1D,RushingLng,RushingY/A,RushingY/G,RushingA/G,ReceivingTgt,ReceivingRec,ReceivingYds,ReceivingY/R,ReceivingTD,Receiving1D,ReceivingLng,ReceivingR/G,ReceivingY/G,ReceivingCtch%,ReceivingY/Tgt,Total YdsTouch,Total YdsY/Tch,Total YdsYScm
Josh Jacobs*+,24,17,17,64,53,400,7.5,0,16,43,3.1,23.5,0.828,6.3,340,1653,12,93,86,4.9,97.2,20,393,5.2,2053,12,3
Derrick Henry*,28,16,16,41,33,398,12.1,0,11,69,2.1,24.9,0.805,9.7,349,1538,13,65,56,4.4,96.1,21.8,382,5.1,1936,13,6
Christian McCaffrey*,26,17,16,108,85,741,8.7,5,36,49,5,43.6,0.787,6.9,244,1139,8,59,49,4.7,67,14.4,329,5.7,1880,13,1
Justin Jefferson*+,23,17,17,184,128,1809,14.1,8,80,64,7.5,106.4,0.696,9.8,4,24,1,2,10,6,1.4,0.2,132,13.9,1833,9,0
Nick Chubb*,27,17,17,37,27,239,8.9,1,12,26,1.6,14.1,0.73,6.5,302,1525,12,69,41,5,89.7,17.8,329,5.4,1764,13,1
Tyreek Hill*+,28,17,17,170,119,1710,14.4,7,77,64,7,100.6,0.7,10.1,7,32,1,3,10,4.6,1.9,0.4,126,13.8,1742,8,1
Saquon Barkley*,25,16,16,76,57,338,5.9,0,10,41,3.6,21.1,0.75,4.4,295,1312,10,62,68,4.4,82,18.4,352,4.7,1650,10,1
Austin Ekeler,27,17,17,127,107,722,6.7,5,36,23,6.3,42.5,0.843,5.7,204,915,13,46,72,4.5,53.8,12,311,5.3,1637,18,5
Aaron Jones,28,17,17,72,59,395,6.7,5,19,30,3.5,23.2,0.819,5.5,213,1121,2,54,36,5.3,65.9,12.5,272,5.6,1516,7,5
Davante Adams*+,30,17,17,180,100,1516,15.2,14,65,60,5.9,89.2,0.556,8.4,3,-1,0,0,4,-0.3,-0.1,0.2,103,14.7,1515,14,1
A.J. Brown*,25,17,16,145,88,1496,17,11,59,78,5.2,88,0.607,10.3,0,0,0,0,0,0,0,0,88,17,1496,11,2
Dalvin Cook*,27,17,17,56,39,295,7.6,2,16,64,2.3,17.4,0.696,5.3,264,1173,8,50,81,4.4,69,15.5,303,4.8,1468,10,4
Rhamondre Stevenson,24,17,7,88,69,421,6.1,1,13,40,4.1,24.8,0.784,4.8,210,1040,5,49,49,5,61.2,12.4,279,5.2,1461,6,4
Travis Etienne,23,17,12,45,35,316,9,0,16,30,2.1,18.6,0.778,7,220,1125,5,52,62,5.1,66.2,12.9,255,5.7,1441,5,5
Stefon Diggs*,29,16,16,154,108,1429,13.2,11,74,53,6.8,89.3,0.701,9.3,1,-3,0,0,-3,-3,-0.2,0.1,109,13.1,1426,11,1
CeeDee Lamb*,23,17,17,156,107,1359,12.7,9,67,39,6.3,79.9,0.686,8.7,10,47,0,3,14,4.7,2.8,0.6,117,12,1406,9,0
Alvin Kamara,27,15,13,77,57,490,8.6,2,17,54,3.8,32.7,0.74,6.4,223,897,2,40,27,4,59.8,14.9,280,5,1387,4,4
Jaylen Waddle,24,17,17,117,75,1356,18.1,8,60,84,4.4,79.8,0.641,11.6,3,26,0,0,9,8.7,1.5,0.2,78,17.7,1382,8,1
Tony Pollard*,25,16,4,55,39,371,9.5,3,18,68,2.4,23.2,0.709,6.7,193,1007,9,46,57,5.2,62.9,12.1,232,5.9,1378,12,0
Miles Sanders*,25,17,15,26,20,78,3.9,0,2,16,1.2,4.6,0.769,3,259,1269,11,62,40,4.9,74.6,15.2,279,4.8,1347,11,2
Travis Kelce*+,33,17,17,152,110,1338,12.2,12,78,52,6.5,78.7,0.724,8.8,2,5,0,1,4,2.5,0.3,0.1,112,12,1343,12,1
Najee Harris,24,17,17,53,41,229,5.6,3,16,19,2.4,13.5,0.774,4.3,272,1034,7,45,36,3.8,60.8,16,313,4,1263,10,3
Amon-Ra St. Brown*,23,16,16,146,106,1161,11,6,68,49,6.6,72.6,0.726,8,9,95,0,3,58,10.6,5.9,0.6,115,10.9,1256,6,0
Joe Mixon,26,14,14,75,60,441,7.4,2,17,35,4.3,31.5,0.8,5.9,210,814,7,47,40,3.9,58.1,15,270,4.6,1255,9,0
Terry McLaurin*,27,17,17,120,77,1191,15.5,5,56,52,4.5,70.1,0.642,9.9,7,29,0,2,12,4.1,1.7,0.4,84,14.5,1220,5,1
Kenneth Walker III,22,15,11,35,27,165,6.1,0,6,33,1.8,11,0.771,4.7,228,1050,9,51,74,4.6,70,15.2,255,4.8,1215,9,0
DeVonta Smith,24,17,17,136,95,1196,12.6,7,57,45,5.6,70.4,0.699,8.8,0,0,0,0,0,0,0,0,95,12.6,1196,7,1
Leonard Fournette,27,16,9,83,73,523,7.2,3,26,44,4.6,32.7,0.88,6.3,189,668,3,39,23,3.5,41.8,11.8,262,4.5,1191,6,0
Tyler Allgeier,22,16,7,17,16,139,8.7,1,8,26,1,8.7,0.941,8.2,210,1035,3,53,44,4.9,64.7,13.1,226,5.2,1174,4,0
Amari Cooper,28,17,17,132,78,1160,14.9,9,61,55,4.6,68.2,0.591,8.8,0,0,0,0,0,0,0,0,78,14.9,1160,9,0
Jamaal Williams,27,17,9,16,12,73,6.1,0,4,17,0.7,4.3,0.75,4.6,262,1066,17,65,58,4.1,62.7,15.4,274,4.2,1139,17,3
Mike Evans,29,15,15,127,77,1124,14.6,6,53,63,5.1,74.9,0.606,8.9,0,0,0,0,0,0,0,0,77,14.6,1124,6,0
Christian Kirk,26,17,17,133,84,1108,13.2,8,55,49,4.9,65.2,0.632,8.3,5,11,0,0,5,2.2,0.6,0.3,89,12.6,1119,8,1
David Montgomery,25,16,16,40,34,316,9.3,1,10,32,2.1,19.8,0.85,7.9,201,801,5,41,28,4,50.1,12.6,235,4.8,1117,6,2
Garrett Wilson,22,17,12,147,83,1103,13.3,4,56,60,4.9,64.9,0.565,7.5,4,4,0,0,7,1,0.2,0.2,87,12.7,1107,4,2
Dameon Pierce,22,13,13,39,30,165,5.5,1,7,16,2.3,12.7,0.769,4.2,220,939,4,54,75,4.3,72.2,16.9,250,4.4,1104,5,4
Devin Singletary,25,16,16,52,38,280,7.4,1,15,22,2.4,17.5,0.731,5.4,177,819,5,43,33,4.6,51.2,11.1,215,5.1,1099,6,3
Raheem Mostert,30,16,14,42,31,202,6.5,2,11,25,1.9,12.6,0.738,4.8,181,891,3,44,67,4.9,55.7,11.3,212,5.2,1093,5,1
James Conner,27,13,13,58,46,300,6.5,1,13,22,3.5,23.1,0.793,5.2,183,782,7,48,23,4.3,60.2,14.1,229,4.7,1082,8,3
Ja'Marr Chase*,22,12,12,134,87,1046,12,9,58,60,7.3,87.2,0.649,7.8,5,8,0,0,6,1.6,0.7,0.4,92,11.5,1054,9,2
D.K. Metcalf,25,17,17,141,90,1048,11.6,6,47,54,5.3,61.6,0.638,7.4,0,0,0,0,0,0,0,0,90,11.6,1048,6,2
Jeff Wilson,27,16,7,37,22,185,8.4,1,7,16,1.4,11.6,0.595,5,176,860,5,43,41,4.9,53.8,11,198,5.3,1045,6,3
Chris Olave,22,15,9,119,72,1042,14.5,4,48,53,4.8,69.5,0.605,8.8,0,0,0,0,0,0,0,0,72,14.5,1042,4,2
Brandon Aiyuk,24,17,17,114,78,1015,13,8,47,54,4.6,59.7,0.684,8.9,2,23,0,1,16,11.5,1.4,0.1,80,13,1038,8,1
Tyler Lockett,30,16,16,117,84,1033,12.3,9,50,40,5.3,64.6,0.718,8.8,0,0,0,0,0,0,0,0,84,12.3,1033,9,2
Tee Higgins,23,16,14,109,74,1029,13.9,7,47,59,4.6,64.3,0.679,9.4,0,0,0,0,0,0,0,0,74,13.9,1029,7,0
Chris Godwin,26,15,13,142,104,1023,9.8,3,53,44,6.9,68.2,0.732,7.2,3,5,0,0,2,1.7,0.3,0.2,107,9.6,1028,3,2
Jerry Jeudy,23,15,14,100,67,972,14.5,6,41,67,4.5,64.8,0.67,9.7,4,40,0,4,14,10,2.7,0.3,71,14.3,1012,6,0
Jonathan Taylor,23,11,11,40,28,143,5.1,0,4,19,2.5,13,0.7,3.6,192,861,4,39,66,4.5,78.3,17.5,220,4.6,1004,4,3
AJ Dillon,24,17,3,43,28,206,7.4,0,9,17,1.6,12.1,0.651,4.8,186,770,7,47,27,4.1,45.3,10.9,214,4.6,976,7,1
Ezekiel Elliott,27,15,14,23,17,92,5.4,0,4,31,1.1,6.1,0.739,4,231,876,12,52,27,3.8,58.4,15.4,248,3.9,968,12,0
Isiah Pacheco,23,17,11,14,13,130,10,0,7,32,0.8,7.6,0.929,9.3,170,830,5,37,31,4.9,48.8,10,183,5.2,960,5,4
Michael Pittman Jr.,25,16,16,141,99,925,9.3,4,51,28,6.2,57.8,0.702,6.6,3,30,0,2,19,10,1.9,0.2,102,9.4,955,4,2
D.J. Moore,25,17,17,118,63,888,14.1,7,44,62,3.7,52.2,0.534,7.5,10,53,0,3,11,5.3,3.1,0.6,73,12.9,941,7,0
D'Onta Foreman,26,17,9,9,5,26,5.2,0,1,23,0.3,1.5,0.556,2.9,203,914,5,45,60,4.5,53.8,11.9,208,4.5,940,5,1
JuJu Smith-Schuster,26,16,14,101,78,933,12,3,47,53,4.9,58.3,0.772,9.2,0,0,0,0,0,0,0,0,78,12,933,3,3
D'Andre Swift,23,14,8,70,48,389,8.1,3,17,25,3.4,27.8,0.686,5.6,99,542,5,21,50,5.5,38.7,7.1,147,6.3,931,8,1
T.J. Hockenson*,25,17,14,129,86,914,10.6,6,44,81,5.1,53.8,0.667,7.1,0,0,0,0,0,0,0,0,86,10.6,914,6,1
Diontae Johnson,26,17,17,147,86,882,10.3,0,45,37,5.1,51.9,0.585,6,7,25,0,1,8,3.6,1.5,0.4,93,9.8,907,0,1
Cam Akers,23,15,9,18,13,117,9,0,8,18,0.9,7.8,0.722,6.5,188,786,7,39,42,4.2,52.4,12.5,201,4.5,903,7,2
Antonio Gibson,24,15,6,58,46,353,7.7,2,18,26,3.1,23.5,0.793,6.1,149,546,3,32,20,3.7,36.4,9.9,195,4.6,899,5,1
Mike Williams,28,13,13,93,63,895,14.2,4,39,55,4.8,68.8,0.677,9.6,0,0,0,0,0,0,0,0,63,14.2,895,4,0
Latavius Murray,32,13,7,35,27,132,4.9,0,4,15,2.1,10.2,0.771,3.8,171,760,6,44,52,4.4,58.5,13.2,198,4.5,892,6,1
Drake London,21,17,15,117,72,866,12,4,48,40,4.2,50.9,0.615,7.4,0,0,0,0,0,0,0,0,72,12,866,4,3
Cooper Kupp,29,9,9,98,75,812,10.8,6,42,75,8.3,90.2,0.765,8.3,9,52,1,4,20,5.8,5.8,1,84,10.3,864,7,2
Deebo Samuel,26,13,12,94,56,632,11.3,2,25,57,4.3,48.6,0.596,6.7,42,232,3,8,51,5.5,17.8,3.2,98,8.8,864,5,3
Brian Robinson Jr.,23,12,9,12,9,60,6.7,1,3,18,0.8,5,0.75,5,205,797,2,49,24,3.9,66.4,17.1,214,4,857,3,2
Mark Andrews*,27,15,15,113,73,847,11.6,5,48,36,4.9,56.5,0.646,7.5,3,8,0,3,4,2.7,0.5,0.2,76,11.3,855,5,1
Curtis Samuel,26,17,12,92,64,656,10.3,4,36,49,3.8,38.6,0.696,7.1,38,187,1,11,21,4.9,11,2.2,102,8.3,843,5,1
Zay Jones,27,16,15,121,82,823,10,5,44,59,5.1,51.4,0.678,6.8,4,18,0,1,14,4.5,1.1,0.3,86,9.8,841,5,0
Donovan Peoples-Jones,23,17,14,96,61,839,13.8,3,33,42,3.6,49.4,0.635,8.7,1,2,0,0,2,2,0.1,0.1,62,13.6,841,3,1
Gabriel Davis,23,15,15,93,48,836,17.4,7,35,98,3.2,55.7,0.516,9,0,0,0,0,0,0,0,0,48,17.4,836,7,1
Courtland Sutton,27,15,15,109,64,829,13,2,38,51,4.3,55.3,0.587,7.6,1,5,0,0,5,5,0.3,0.1,65,12.8,834,2,0
George Pickens,21,17,12,84,52,801,15.4,4,38,42,3.1,47.1,0.619,9.5,3,24,1,2,22,8,1.4,0.2,55,15,825,5,0
Cordarrelle Patterson,31,13,11,31,21,122,5.8,0,6,16,1.6,9.4,0.677,3.9,144,695,8,39,40,4.8,53.5,11.1,165,5,817,8,1
Jerick McKinnon,30,17,0,71,56,512,9.1,9,28,56,3.3,30.1,0.789,7.2,72,291,1,12,30,4,17.1,4.2,128,6.3,803,10,1
Jakobi Meyers,26,14,13,96,67,804,12,6,38,48,4.8,57.4,0.698,8.4,2,-11,0,2,7,-5.5,-0.8,0.1,69,11.5,793,6,2
Khalil Herbert,24,13,1,12,9,57,6.3,1,2,25,0.7,4.4,0.75,4.8,129,731,4,26,63,5.7,56.2,9.9,138,5.7,788,5,0
Allen Lazard,27,15,15,100,60,788,13.1,6,45,47,4,52.5,0.6,7.9,2,0,0,0,1,0,0,0.1,62,12.7,788,6,0
Evan Engram,28,17,14,98,73,766,10.5,4,33,36,4.3,45.1,0.745,7.8,2,13,0,1,13,6.5,0.8,0.1,75,10.4,779,4,0
Josh Palmer,24,16,11,107,72,769,10.7,3,39,50,4.5,48.1,0.673,7.2,1,4,0,1,4,4,0.3,0.1,73,10.6,773,3,1
Rachaad White,23,17,8,58,50,290,5.8,2,13,20,2.9,17.1,0.862,5,129,481,1,27,35,3.7,28.3,7.6,179,4.3,771,3,3
George Kittle*,29,15,15,86,60,765,12.8,11,36,54,4,51,0.698,8.9,0,0,0,0,0,0,0,0,60,12.8,765,11,1
Tyler Boyd,28,16,14,82,58,762,13.1,5,42,60,3.6,47.6,0.707,9.3,0,0,0,0,0,0,0,0,58,13.1,762,5,0
Keenan Allen,30,10,10,89,66,752,11.4,4,39,46,6.6,75.2,0.742,8.4,1,8,0,1,8,8,0.8,0.1,67,11.3,760,4,1
Pat Freiermuth,24,16,8,98,63,732,11.6,2,37,57,3.9,45.8,0.643,7.5,0,0,0,0,0,0,0,0,63,11.6,732,2,0
Mack Hollins,29,17,16,94,57,690,12.1,4,34,60,3.4,40.6,0.606,7.3,4,40,0,2,17,10,2.4,0.2,61,12,730,4,0
Darius Slayton,25,16,11,71,46,724,15.7,2,30,55,2.9,45.3,0.648,10.2,0,0,0,0,0,0,0,0,46,15.7,724,2,2
Adam Thielen,32,17,17,107,70,716,10.2,6,45,36,4.1,42.1,0.654,6.7,1,4,0,0,4,4,0.2,0.1,71,10.1,720,6,0
DeAndre Hopkins,30,9,9,96,64,717,11.2,3,35,33,7.1,79.7,0.667,7.5,0,0,0,0,0,0,0,0,64,11.2,717,3,2
Marquise Brown,25,12,10,107,67,709,10.6,3,33,47,5.6,59.1,0.626,6.6,1,1,0,0,1,1,0.1,0.1,68,10.4,710,3,1
Brandin Cooks,29,13,13,93,57,699,12.3,3,29,44,4.4,53.8,0.613,7.5,2,7,0,0,5,3.5,0.5,0.2,59,12,706,3,0
Dallas Goedert,27,12,12,69,55,702,12.8,3,40,31,4.6,58.5,0.797,10.2,0,0,0,0,0,0,0,0,55,12.8,702,3,1
Christian Watson,23,14,11,66,41,611,14.9,7,28,63,2.9,43.6,0.621,9.3,7,80,2,2,46,11.4,5.7,0.5,48,14.4,691,9,0
Michael Carter,23,16,10,54,41,288,7,0,12,37,2.6,18,0.759,5.3,114,402,3,14,25,3.5,25.1,7.1,155,4.5,690,3,2
James Cook,23,16,0,32,21,180,8.6,1,5,41,1.3,11.3,0.656,5.6,89,507,2,25,33,5.7,31.7,5.6,110,6.2,687,3,1
Marquez Valdes-Scantling,28,17,11,81,42,687,16.4,2,32,57,2.5,40.4,0.519,8.5,1,-3,0,0,-3,-3,-0.2,0.1,43,15.9,684,2,0
Parris Campbell,25,17,16,91,63,623,9.9,3,32,49,3.7,36.6,0.692,6.8,5,58,0,2,28,11.6,3.4,0.3,68,10,681,3,1
Breece Hall,21,7,2,31,19,218,11.5,1,8,79,2.7,31.1,0.613,7,80,463,4,20,62,5.8,66.1,11.4,99,6.9,681,5,1
Samaje Perine,27,16,2,51,38,287,7.6,4,11,32,2.4,17.9,0.745,5.6,95,394,2,19,29,4.1,24.6,5.9,133,5.1,681,6,0
Kareem Hunt,27,17,0,44,35,210,6,1,11,24,2.1,12.4,0.795,4.8,123,468,3,30,24,3.8,27.5,7.2,158,4.3,678,4,1
K.J. Osborn,25,17,9,90,60,650,10.8,5,32,66,3.5,38.2,0.667,7.2,3,6,0,2,5,2,0.4,0.2,63,10.4,656,5,1
Taysom Hill,32,16,8,13,9,77,8.6,2,5,30,0.6,4.8,0.692,5.9,96,575,7,34,60,6,35.9,6,105,6.2,652,9,2
Kalif Raymond,28,17,7,64,47,616,13.1,0,24,56,2.8,36.2,0.734,9.6,7,36,0,4,12,5.1,2.1,0.4,54,12.1,652,0,3
Chuba Hubbard,23,15,2,17,14,171,12.2,0,5,45,0.9,11.4,0.824,10.1,95,466,2,23,35,4.9,31.1,6.3,109,5.8,637,2,2
Tyler Higbee,29,17,17,108,72,620,8.6,3,32,26,4.2,36.5,0.667,5.7,0,0,0,0,0,0,0,0,72,8.6,620,3,0
David Njoku,26,14,14,80,58,628,10.8,4,36,38,4.1,44.9,0.725,7.9,2,-8,0,0,-2,-4,-0.6,0.1,60,10.3,620,4,1
Alec Pierce,22,16,12,78,41,593,14.5,2,28,47,2.6,37.1,0.526,7.6,0,0,0,0,0,0,0,0,41,14.5,593,2,1
Jaylen Warren,24,16,0,33,28,214,7.6,0,14,26,1.8,13.4,0.848,6.5,77,379,1,20,31,4.9,23.7,4.8,105,5.6,593,1,1
Dalton Schultz,26,15,15,89,57,577,10.1,5,27,30,3.8,38.5,0.64,6.5,0,0,0,0,0,0,0,0,57,10.1,577,5,1
Richie James,27,17,4,70,57,569,10,4,29,33,3.4,33.5,0.814,8.1,2,6,0,0,4,3,0.4,0.1,59,9.7,575,4,3
Kenyan Drake,28,12,5,26,17,89,5.2,1,7,15,1.4,7.4,0.654,3.4,109,482,4,21,40,4.4,40.2,9.1,126,4.5,571,5,1
J.K. Dobbins,24,8,8,8,7,42,6,1,3,20,0.9,5.3,0.875,5.3,92,520,2,26,44,5.7,65,11.5,99,5.7,562,3,0
Damien Harris,25,11,9,23,17,97,5.7,0,4,15,1.5,8.8,0.739,4.2,106,462,3,23,30,4.4,42,9.6,123,4.5,559,3,0
Noah Brown,26,16,13,74,43,555,12.9,3,25,51,2.7,34.7,0.581,7.5,0,0,0,0,0,0,0,0,43,12.9,555,3,1
Tyler Conklin,27,17,16,87,58,552,9.5,3,25,30,3.4,32.5,0.667,6.3,2,3,0,2,2,1.5,0.2,0.1,60,9.3,555,3,2
Gerald Everett,28,16,11,87,58,555,9.6,4,29,26,3.6,34.7,0.667,6.4,1,0,0,0,0,0,0,0.1,59,9.4,555,4,0
Cole Kmet,23,17,17,69,50,544,10.9,7,27,50,2.9,32,0.725,7.9,2,9,0,1,8,4.5,0.5,0.1,52,10.6,553,7,1
Chris Moore,29,16,7,74,48,548,11.4,2,24,52,3,34.3,0.649,7.4,3,3,0,0,3,1,0.2,0.2,51,10.8,551,2,0
Rashid Shaheed,24,12,6,34,28,488,17.4,2,18,68,2.3,40.7,0.824,14.4,4,57,1,2,44,14.3,4.8,0.3,32,17,545,3,1
Melvin Gordon,29,10,6,32,25,223,8.9,0,11,24,2.5,22.3,0.781,7,90,318,2,15,17,3.5,31.8,9,115,4.7,541,2,5
Olamide Zaccheaus,25,17,13,61,40,533,13.3,3,25,45,2.4,31.4,0.656,8.7,2,7,0,1,13,3.5,0.4,0.1,42,12.9,540,3,1
DeVante Parker,29,13,11,47,31,539,17.4,3,25,43,2.4,41.5,0.66,11.5,0,0,0,0,0,0,0,0,31,17.4,539,3,0
Corey Davis,27,13,10,64,32,536,16.8,2,28,66,2.5,41.2,0.5,8.4,0,0,0,0,0,0,0,0,32,16.8,536,2,0
Marvin Jones,32,16,10,81,46,529,11.5,3,29,37,2.9,33.1,0.568,6.5,0,0,0,0,0,0,0,0,46,11.5,529,3,0
Robert Woods,30,17,15,91,53,527,9.9,2,31,41,3.1,31,0.582,5.8,0,0,0,0,0,0,0,0,53,9.9,527,2,1
DeAndre Carter,29,17,7,65,46,538,11.7,3,29,35,2.7,31.6,0.708,8.3,2,-15,0,0,-5,-7.5,-0.9,0.1,48,10.9,523,3,3
Dawson Knox*,26,15,15,65,48,517,10.8,6,25,45,3.2,34.5,0.738,8,0,0,0,0,0,0,0,0,48,10.8,517,6,0
Jahan Dotson,22,12,10,61,35,523,14.9,7,26,61,2.9,43.6,0.574,8.6,2,-7,0,0,3,-3.5,-0.6,0.2,37,13.9,516,7,0
Greg Dortch,24,16,4,64,52,467,9,2,19,47,3.3,29.2,0.813,7.3,7,44,0,3,20,6.3,2.8,0.4,59,8.7,511,2,1
Chase Claypool,24,15,11,79,46,451,9.8,1,24,31,3.1,30.1,0.582,5.7,9,59,0,3,15,6.6,3.9,0.6,55,9.3,510,1,1
Hunter Henry,28,17,14,59,41,509,12.4,2,23,39,2.4,29.9,0.695,8.6,0,0,0,0,0,0,0,0,41,12.4,509,2,0
Juwan Johnson,26,16,12,65,42,508,12.1,7,25,41,2.6,31.8,0.646,7.8,0,0,0,0,0,0,0,0,42,12.1,508,7,0
DJ Chark,26,11,10,52,30,502,16.7,3,24,51,2.7,45.6,0.577,9.7,0,0,0,0,0,0,0,0,30,16.7,502,3,0
Jordan Akins,30,15,3,54,37,495,13.4,5,23,46,2.5,33,0.685,9.2,0,0,0,0,0,0,0,0,37,13.4,495,5,1
Darnell Mooney,25,12,12,61,40,493,12.3,2,20,56,3.3,41.1,0.656,8.1,1,2,0,0,2,2,0.2,0.1,41,12.1,495,2,0
Zack Moss,25,13,3,13,11,39,3.5,0,2,8,0.8,3,0.846,3,93,456,1,18,43,4.9,35.1,7.2,104,4.8,495,1,1
Treylon Burks,22,11,6,54,33,444,13.5,1,19,51,3,40.4,0.611,8.2,4,47,0,3,20,11.8,4.3,0.4,37,13.3,491,1,0
Devin Duvernay*,25,14,13,49,37,407,11,3,19,31,2.6,29.1,0.755,8.3,12,84,1,7,18,7,6,0.9,49,10,491,4,1
Terrace Marshall Jr.,22,14,9,47,28,490,17.5,1,24,43,2,35,0.596,10.4,0,0,0,0,0,0,0,0,28,17.5,490,1,2
Noah Fant,25,17,16,63,50,486,9.7,4,24,51,2.9,28.6,0.794,7.7,0,0,0,0,0,0,0,0,50,9.7,486,4,0
Nico Collins,23,10,7,66,37,481,13,2,21,58,3.7,48.1,0.561,7.3,0,0,0,0,0,0,0,0,37,13,481,2,0
Josh Reynolds,27,14,11,59,38,479,12.6,3,25,31,2.7,34.2,0.644,8.1,0,0,0,0,0,0,0,0,38,12.6,479,3,0
Isaiah McKenzie,27,15,8,65,42,423,10.1,4,27,30,2.8,28.2,0.646,6.5,9,55,1,3,18,6.1,3.7,0.6,51,9.4,478,5,0
James Robinson,24,11,5,14,11,51,4.6,2,5,10,1,4.6,0.786,3.6,110,425,3,22,50,3.9,38.6,10,121,3.9,476,5,1
Kendrick Bourne,27,16,2,48,35,434,12.4,1,22,41,2.2,27.1,0.729,9,6,39,0,2,29,6.5,2.4,0.4,41,11.5,473,1,2
Robert Tonyan,28,17,3,67,53,470,8.9,2,20,24,3.1,27.6,0.791,7,0,0,0,0,0,0,0,0,53,8.9,470,2,0
Demarcus Robinson,28,17,5,75,48,458,9.5,2,23,31,2.8,26.9,0.64,6.1,0,0,0,0,0,0,0,0,48,9.5,458,2,2
Clyde Edwards-Helaire,23,10,6,23,17,151,8.9,3,11,25,1.7,15.1,0.739,6.6,71,302,3,15,52,4.3,30.2,7.1,88,5.1,453,6,0
Chigoziem Okonkwo,23,17,8,46,32,450,14.1,3,22,48,1.9,26.5,0.696,9.8,3,2,0,0,6,0.7,0.1,0.2,35,12.9,452,3,0
Elijah Moore,22,16,9,65,37,446,12.1,1,22,42,2.3,27.9,0.569,6.9,5,5,0,2,10,1,0.3,0.3,42,10.7,451,1,1
Deon Jackson,23,16,2,34,30,209,7,1,10,27,1.9,13.1,0.882,6.1,68,236,1,13,17,3.5,14.8,4.3,98,4.5,445,2,1
Austin Hooper,28,17,2,60,41,444,10.8,2,28,24,2.4,26.1,0.683,7.4,0,0,0,0,0,0,0,0,41,10.8,444,2,0
Romeo Doubs,22,13,7,67,42,425,10.1,3,20,26,3.2,32.7,0.627,6.3,1,11,0,1,11,11,0.8,0.1,43,10.1,436,3,2
Gus Edwards,27,9,4,2,0,0,0,0,0,0,0,0,0,0,87,433,3,30,37,5,48.1,9.7,87,5,433,3,1
Russell Gage,26,13,4,70,51,426,8.4,5,31,23,3.9,32.8,0.729,6.1,0,0,0,0,0,0,0,0,51,8.4,426,5,1
Michael Gallup,26,14,11,74,39,424,10.9,4,25,27,2.8,30.3,0.527,5.7,0,0,0,0,0,0,0,0,39,10.9,424,4,0
Foster Moreau,25,15,14,54,33,420,12.7,2,24,33,2.2,28,0.611,7.8,0,2,0,0,0,0,0.1,0,33,12.8,422,2,1
Randall Cobb,32,13,3,50,34,417,12.3,1,19,40,2.6,32.1,0.68,8.3,0,0,0,0,0,0,0,0,34,12.3,417,1,1
Trent Sherfield,26,17,4,51,30,417,13.9,2,18,75,1.8,24.5,0.588,8.2,0,0,0,0,0,0,0,0,30,13.9,417,2,0
Jauan Jennings,25,16,4,56,35,416,11.9,1,23,44,2.2,26,0.625,7.4,0,0,0,0,0,0,0,0,35,11.9,416,1,1
Hayden Hurst,29,13,13,68,52,414,8,2,26,29,4,31.8,0.765,6.1,0,0,0,0,0,0,0,0,52,8,414,2,0
Greg Dulcich,22,10,6,55,33,411,12.5,2,18,39,3.3,41.1,0.6,7.5,0,0,0,0,0,0,0,0,33,12.5,411,2,0
Kenneth Gainwell,23,17,0,29,23,169,7.3,0,7,20,1.4,9.9,0.793,5.8,53,240,4,17,13,4.5,14.1,3.1,76,5.4,409,4,0
Rondale Moore,22,8,8,56,41,414,10.1,1,16,38,5.1,51.8,0.732,7.4,6,-5,0,1,9,-0.8,-0.6,0.8,47,8.7,409,1,0
Zach Ertz,32,10,10,69,47,406,8.6,4,24,32,4.7,40.6,0.681,5.9,0,0,0,0,0,0,0,0,47,8.6,406,4,0
Chase Edmonds,26,13,3,24,16,157,9.8,1,7,27,1.2,12.1,0.667,6.5,68,245,2,8,28,3.6,18.8,5.2,84,4.8,402,3,0
Zonovan Knight,21,7,4,14,13,100,7.7,0,5,16,1.9,14.3,0.929,7.1,85,300,1,14,48,3.5,42.9,12.1,98,4.1,400,1,2
Nick Westbrook-Ikhine,25,17,13,50,25,397,15.9,3,18,63,1.5,23.4,0.5,7.9,0,0,0,0,0,0,0,0,25,15.9,397,3,0
Ben Skowronek,25,14,11,61,39,376,9.6,0,16,32,2.8,26.9,0.639,6.2,1,17,1,1,17,17,1.2,0.1,40,9.8,393,1,0
Marquise Goodwin,32,13,2,42,27,387,14.3,4,18,38,2.1,29.8,0.643,9.2,2,5,0,0,7,2.5,0.4,0.2,29,13.5,392,4,0
Isaiah Hodgins,24,10,5,48,37,392,10.6,4,24,29,3.7,39.2,0.771,8.2,0,0,0,0,0,0,0,0,37,10.6,392,4,1
Cade Otton,23,16,11,65,42,391,9.3,2,19,35,2.6,24.4,0.646,6,0,0,0,0,0,0,0,0,42,9.3,391,2,0
Joshua Kelley,25,13,1,25,14,101,7.2,0,4,22,1.1,7.8,0.56,4,69,287,2,16,22,4.2,22.1,5.3,83,4.7,388,2,0
Darren Waller,30,9,6,43,28,388,13.9,3,18,34,3.1,43.1,0.651,9,0,0,0,0,0,0,0,0,28,13.9,388,3,0
Darrell Henderson,25,10,7,22,17,102,6,0,5,15,1.7,10.2,0.773,4.6,70,283,3,14,23,4,28.3,7,87,4.4,385,3,0
Equanimeous St. Brown,26,16,16,38,21,323,15.4,1,14,56,1.3,20.2,0.553,8.5,6,54,0,2,41,9,3.4,0.4,27,14,377,1,1
Alexander Mattison,24,17,0,18,15,91,6.1,1,4,16,0.9,5.4,0.833,5.1,74,283,5,21,15,3.8,16.6,4.4,89,4.2,374,6,0
Isaiah Likely,22,16,2,60,36,373,10.4,3,18,34,2.3,23.3,0.6,6.2,0,0,0,0,0,0,0,0,36,10.4,373,3,0
Caleb Huntley,24,12,0,2,2,3,1.5,0,0,2,0.2,0.3,1,1.5,76,366,1,18,30,4.8,30.5,6.3,78,4.7,369,1,1
Van Jefferson,26,11,9,44,24,369,15.4,3,20,39,2.2,33.5,0.545,8.4,0,0,0,0,0,0,0,0,24,15.4,369,3,0
Nelson Agholor,29,16,7,53,31,362,11.7,2,12,44,1.9,22.6,0.585,6.8,0,0,0,0,0,0,0,0,31,11.7,362,2,2
Mike Gesicki,27,17,1,52,32,362,11.3,5,19,32,1.9,21.3,0.615,7,0,0,0,0,0,0,0,0,32,11.3,362,5,0
Rashaad Penny,26,5,5,5,4,16,4,0,2,6,0.8,3.2,0.8,3.2,57,346,2,15,41,6.1,69.2,11.4,61,5.9,362,2,1
Kyle Pitts,22,10,10,59,28,356,12.7,2,20,33,2.8,35.6,0.475,6,0,0,0,0,0,0,0,0,28,12.7,356,2,0
Quez Watkins,24,17,8,51,33,354,10.7,3,13,53,1.9,20.8,0.647,6.9,3,1,0,0,4,0.3,0.1,0.2,36,9.9,355,3,1
Will Dissly,26,15,15,38,34,349,10.3,3,20,38,2.3,23.3,0.895,9.2,0,0,0,0,0,0,0,0,34,10.3,349,3,0
Julio Jones,33,10,5,43,24,299,12.5,2,13,48,2.4,29.9,0.558,7,5,45,0,4,15,9,4.5,0.5,29,11.9,344,2,0
Allen Robinson,29,10,10,52,33,339,10.3,3,23,29,3.3,33.9,0.635,6.5,0,0,0,0,0,0,0,0,33,10.3,339,3,0
Matt Breida,27,17,1,25,20,118,5.9,0,5,16,1.2,6.9,0.8,4.7,54,220,1,13,18,4.1,12.9,3.2,74,4.6,338,1,0
Laviska Shenault Jr.,24,13,4,32,27,272,10.1,1,10,67,2.1,20.9,0.844,8.5,9,65,1,1,41,7.2,5,0.7,36,9.4,337,2,0
Tutu Atwell,23,13,4,35,18,298,16.6,1,11,62,1.4,22.9,0.514,8.5,9,34,1,2,11,3.8,2.6,0.7,27,12.3,332,2,0
Hunter Renfrow,27,10,1,50,36,330,9.2,2,18,27,3.6,33,0.72,6.6,0,0,0,0,0,0,0,0,36,9.2,330,2,3
Mecole Hardman,24,8,5,34,25,297,11.9,4,14,36,3.1,37.1,0.735,8.7,4,31,2,3,25,7.8,3.9,0.5,29,11.3,328,6,1
Kendall Hinton,25,12,5,33,24,311,13,0,14,35,2,25.9,0.727,9.4,2,13,0,1,13,6.5,1.1,0.2,26,12.5,324,0,0
Logan Thomas,31,14,13,61,39,323,8.3,1,15,27,2.8,23.1,0.639,5.3,0,0,0,0,0,0,0,0,39,8.3,323,1,0
Dontrell Hilliard,27,12,1,26,21,177,8.4,4,8,31,1.8,14.8,0.808,6.8,22,145,0,4,30,6.6,12.1,1.8,43,7.5,322,4,0
Colby Parkinson,23,17,2,34,25,322,12.9,2,14,39,1.5,18.9,0.735,9.5,0,0,0,0,0,0,0,0,25,12.9,322,2,0
Ray-Ray McCloud,26,17,2,25,14,243,17.4,1,11,42,0.8,14.3,0.56,9.7,4,78,1,1,71,19.5,4.6,0.2,18,17.8,321,2,2
Jamycal Hasty,26,17,0,26,20,126,6.3,1,7,28,1.2,7.4,0.769,4.8,46,194,2,7,61,4.2,11.4,2.7,66,4.8,320,3,0
Justice Hill,25,15,0,12,12,58,4.8,0,2,15,0.8,3.9,1,4.8,49,262,0,15,34,5.3,17.5,3.3,61,5.2,320,0,2
Justin Watson,26,17,5,34,15,315,21,2,12,67,0.9,18.5,0.441,9.3,0,0,0,0,0,0,0,0,15,21,315,2,0
DeeJay Dallas,24,15,0,19,17,126,7.4,0,5,41,1.1,8.4,0.895,6.6,35,186,0,9,27,5.3,12.4,2.3,52,6,312,0,1
Jelani Woods,24,15,2,40,25,312,12.5,3,16,36,1.7,20.8,0.625,7.8,0,0,0,0,0,0,0,0,25,12.5,312,3,1
Kylen Granson,24,13,4,40,31,302,9.7,0,17,32,2.4,23.2,0.775,7.6,1,0,0,0,0,0,0,0.1,32,9.4,302,0,1
Mark Ingram,33,10,3,18,16,68,4.3,0,2,11,1.6,6.8,0.889,3.8,62,233,1,12,14,3.8,23.3,6.2,78,3.9,301,1,2
Noah Gray,23,17,8,34,28,299,10.7,1,14,27,1.6,17.6,0.824,8.8,1,1,1,1,1,1,0.1,0.1,29,10.3,300,2,0
Shi Smith,24,17,6,41,22,296,13.5,2,14,38,1.3,17.4,0.537,7.2,0,0,0,0,0,0,0,0,22,13.5,296,2,4
Elijah Mitchell,24,5,1,4,3,7,2.3,0,0,5,0.6,1.4,0.75,1.8,45,279,2,15,37,6.2,55.8,9,48,6,286,2,0
Rashod Bateman,23,6,5,28,15,285,19,2,7,75,2.5,47.5,0.536,10.2,0,0,0,0,0,0,0,0,15,19,285,2,1
Rex Burkhead,32,16,0,51,37,204,5.5,1,8,17,2.3,12.8,0.725,4,26,80,0,4,9,3.1,5,1.6,63,4.5,284,1,0
Chosen Anderson,29,16,7,44,20,282,14.1,1,10,75,1.3,17.6,0.455,6.4,0,0,0,0,0,0,0,0,20,14.1,282,1,1
Dante Pettis,27,17,7,41,19,245,12.9,3,9,51,1.1,14.4,0.463,6,2,37,0,2,29,18.5,2.2,0.1,21,13.4,282,3,1
Javonte Williams,22,4,4,22,16,76,4.8,0,4,13,4,19,0.727,3.5,47,204,0,9,17,4.3,51,11.8,63,4.4,280,0,1
Tre'Quan Smith,26,15,6,27,19,278,14.6,1,14,48,1.3,18.5,0.704,10.3,0,0,0,0,0,0,0,0,19,14.6,278,1,0
Nyheim Hines,26,16,5,37,30,241,8,1,11,22,1.9,15.1,0.811,6.5,24,33,1,2,9,1.4,2.1,1.5,54,5.1,274,2,2
Skyy Moore,22,16,3,33,22,250,11.4,0,13,30,1.4,15.6,0.667,7.6,3,24,0,1,12,8,1.5,0.2,25,11,274,0,3
Jamal Agnew*,27,15,0,30,23,187,8.1,3,9,24,1.5,12.5,0.767,6.2,12,86,0,6,30,7.2,5.7,0.8,35,7.8,273,3,0
Jarvis Landry,30,9,3,39,25,272,10.9,1,12,40,2.8,30.2,0.641,7,0,0,0,0,0,0,0,0,25,10.9,272,1,1
Justin Jackson,26,16,0,19,12,101,8.4,1,7,15,0.8,6.3,0.632,5.3,42,170,1,8,27,4,10.6,2.6,54,5,271,2,0
Daniel Bellinger,22,12,11,35,30,268,8.9,2,14,24,2.5,22.3,0.857,7.7,1,2,1,1,2,2,0.2,0.1,31,8.7,270,3,1
Damiere Byrd,29,14,4,23,13,268,20.6,2,9,75,0.9,19.1,0.565,11.7,0,0,0,0,0,0,0,0,13,20.6,268,2,0
J.D. McKissic,29,8,0,40,27,173,6.4,0,7,14,3.4,21.6,0.675,4.3,22,95,0,5,33,4.3,11.9,2.8,49,5.5,268,0,0
Trey McBride,23,16,13,39,29,265,9.1,1,12,29,1.8,16.6,0.744,6.8,0,0,0,0,0,0,0,0,29,9.1,265,1,1
Tyquan Thornton,22,13,9,45,22,247,11.2,2,13,29,1.7,19,0.489,5.5,3,16,1,1,19,5.3,1.2,0.2,25,10.5,263,3,0
Jordan Mason,23,16,0,0,0,0,0,0,0,0,0,0,0,0,43,258,1,10,55,6,16.1,2.7,43,6,258,1,0
Phillip Dorsett,29,15,4,40,20,257,12.9,1,11,34,1.3,17.1,0.5,6.4,0,0,0,0,0,0,0,0,20,12.9,257,1,0
Kadarius Toney,23,9,4,20,16,171,10.7,2,8,38,1.8,19,0.8,8.6,7,82,1,5,32,11.7,9.1,0.8,23,11,253,3,1
Jonnu Smith,27,14,8,38,27,245,9.1,0,9,53,1.9,17.5,0.711,6.4,1,5,0,1,5,5,0.4,0.1,28,8.9,250,0,1
Ty Johnson,25,17,1,24,12,88,7.3,0,3,16,0.7,5.2,0.5,3.7,30,160,1,5,32,5.3,9.4,1.8,42,5.9,248,1,0
Harrison Bryant,24,17,9,42,31,239,7.7,1,12,30,1.8,14.1,0.738,5.7,1,8,0,1,8,8,0.5,0.1,32,7.7,247,1,0
Trenton Irwin,27,9,2,23,15,231,15.4,4,12,45,1.7,25.7,0.652,10,1,11,0,1,11,11,1.2,0.1,16,15.1,242,4,0
Braxton Berrios,27,17,2,32,18,145,8.1,0,8,25,1.1,8.5,0.563,4.5,9,91,2,5,25,10.1,5.4,0.5,27,8.7,236,2,1
A.J. Green,34,15,10,47,24,236,9.8,2,11,77,1.6,15.7,0.511,5,0,0,0,0,0,0,0,0,24,9.8,236,2,0
Brandon Powell,27,17,6,32,24,156,6.5,0,7,16,1.4,9.2,0.75,4.9,17,80,0,6,20,4.7,4.7,1,41,5.8,236,0,1
Boston Scott,27,15,2,6,5,15,3,0,0,5,0.3,1,0.833,2.5,54,217,3,12,21,4,14.5,3.6,59,3.9,232,3,0
C.J. Uzomah,29,15,13,27,21,232,11,2,10,40,1.4,15.5,0.778,8.6,0,0,0,0,0,0,0,0,21,11,232,2,0
Ameer Abdullah,29,17,0,32,25,211,8.4,1,8,23,1.5,12.4,0.781,6.6,4,20,0,2,7,5,1.2,0.2,29,8,231,1,0
Travis Homer,24,10,1,18,16,157,9.8,1,7,27,1.6,15.7,0.889,8.7,19,74,0,4,16,3.9,7.4,1.9,35,6.6,231,1,1
Dare Ogunbowale,28,17,4,26,20,104,5.2,0,5,23,1.2,6.1,0.769,4,42,123,1,10,11,2.9,7.2,2.5,62,3.7,227,1,0
Wan'Dale Robinson,21,6,3,31,23,227,9.9,1,13,19,3.8,37.8,0.742,7.3,2,-1,0,0,4,-0.5,-0.2,0.3,25,9,226,1,0
Malik Davis,24,12,0,7,6,63,10.5,0,5,18,0.5,5.3,0.857,9,38,161,1,6,23,4.2,13.4,3.2,44,5.1,224,1,0
Craig Reynolds,26,9,0,10,9,116,12.9,0,5,36,1,12.9,0.9,11.6,23,102,0,4,21,4.4,11.3,2.6,32,6.8,218,0,0
Brock Wright,24,17,10,24,18,216,12,4,13,51,1.1,12.7,0.75,9,0,0,0,0,0,0,0,0,18,12,216,4,0
Ashton Dulin,25,12,2,22,15,207,13.8,1,12,39,1.3,17.3,0.682,9.4,2,8,0,1,5,4,0.7,0.2,17,12.6,215,1,0
Kyren Williams,22,10,0,12,9,76,8.4,0,5,15,0.9,7.6,0.75,6.3,35,139,0,6,17,4,13.9,3.5,44,4.9,215,0,0
David Bell,22,16,3,35,24,214,8.9,0,7,20,1.5,13.4,0.686,6.1,0,0,0,0,0,0,0,0,24,8.9,214,0,0
Velus Jones Jr.,25,12,2,14,7,107,15.3,1,4,44,0.6,8.9,0.5,7.6,9,103,1,5,42,11.4,8.6,0.8,16,13.1,210,2,3
Adam Trautman,25,15,12,22,18,207,11.5,1,9,22,1.2,13.8,0.818,9.4,0,0,0,0,0,0,0,0,18,11.5,207,1,0
KhaDarel Hodge,27,17,1,20,13,202,15.5,1,7,39,0.8,11.9,0.65,10.1,0,0,0,0,0,0,0,0,13,15.5,202,1,0
Mike Boone,27,9,0,15,9,96,10.7,0,2,34,1,10.7,0.6,6.4,24,102,0,6,18,4.3,11.3,2.7,33,6,198,0,0
Ian Thomas,26,17,17,30,21,197,9.4,0,8,50,1.2,11.6,0.7,6.6,0,0,0,0,0,0,0,0,21,9.4,197,0,0
Scott Miller,25,15,1,40,23,185,8,0,8,23,1.5,12.3,0.575,4.6,1,8,0,0,8,8,0.5,0.1,24,8,193,0,0
Jonathan Williams,28,13,2,10,7,40,5.7,0,2,21,0.5,3.1,0.7,4,37,152,0,6,23,4.1,11.7,2.8,44,4.4,192,0,0
Mo Alie-Cox,29,17,11,28,19,189,9.9,3,9,34,1.1,11.1,0.679,6.8,0,0,0,0,0,0,0,0,19,9.9,189,3,1
KJ Hamler,23,7,0,14,7,165,23.6,0,3,55,1,23.6,0.5,11.8,2,23,0,1,14,11.5,3.3,0.3,9,20.9,188,0,0
Denzel Mims,25,10,4,25,11,186,16.9,0,7,63,1.1,18.6,0.44,7.4,0,0,0,0,0,0,0,0,11,16.9,186,0,0
Irv Smith Jr.,24,8,1,36,25,182,7.3,2,9,17,3.1,22.8,0.694,5.1,0,0,0,0,0,0,0,0,25,7.3,182,2,1
Gary Brightwell,23,17,0,8,5,39,7.8,0,4,12,0.3,2.3,0.625,4.9,31,141,1,9,25,4.5,8.3,1.8,36,5,180,1,0
Jalen Nailor,23,15,0,13,9,179,19.9,1,7,47,0.6,11.9,0.692,13.8,0,0,0,0,0,0,0,0,9,19.9,179,1,0
Connor Heyward,23,17,0,17,12,151,12.6,1,6,45,0.7,8.9,0.706,8.9,2,27,0,2,21,13.5,1.6,0.1,14,12.7,178,1,0
Cameron Brate,31,11,1,38,20,174,8.7,0,8,21,1.8,15.8,0.526,4.6,0,0,0,0,0,0,0,0,20,8.7,174,0,0
Jake Ferguson,23,16,8,22,19,174,9.2,2,8,30,1.2,10.9,0.864,7.9,0,0,0,0,0,0,0,0,19,9.2,174,2,0
Steven Sims,25,12,2,23,14,104,7.4,0,5,28,1.2,8.7,0.609,4.5,13,70,0,5,22,5.4,5.8,1.1,27,6.4,174,0,3
Tommy Tremble,22,17,4,32,19,174,9.2,3,9,29,1.1,10.2,0.594,5.4,0,0,0,0,0,0,0,0,19,9.2,174,3,1
Michael Thomas,29,3,3,22,16,171,10.7,3,13,21,5.3,57,0.727,7.8,0,0,0,0,0,0,0,0,16,10.7,171,3,0
Raheem Blackshear,23,13,1,12,10,93,9.3,0,3,27,0.8,7.2,0.833,7.8,23,77,3,7,16,3.3,5.9,1.8,33,5.2,170,3,1
Avery Williams,24,17,3,14,13,61,4.7,0,3,10,0.8,3.6,0.929,4.4,22,109,1,6,21,5,6.4,1.3,35,4.9,170,1,1
Khalil Shakir,22,14,2,20,10,161,16.1,1,7,31,0.7,11.5,0.5,8.1,0,0,0,0,0,0,0,0,10,16.1,161,1,0
Sony Michel,27,10,0,13,9,53,5.9,0,1,9,0.9,5.3,0.692,4.1,36,106,0,8,12,2.9,10.6,3.6,45,3.5,159,0,0
Dyami Brown,23,15,0,14,5,143,28.6,2,5,75,0.3,9.5,0.357,10.2,1,15,0,1,15,15,1,0.1,6,26.3,158,2,0
Marquez Callaway,24,14,3,32,16,158,9.9,1,11,33,1.1,11.3,0.5,4.9,0,0,0,0,0,0,0,0,16,9.9,158,1,0
Sterling Shepard,29,3,2,24,13,154,11.8,1,4,65,4.3,51.3,0.542,6.4,0,0,0,0,0,0,0,0,13,11.8,154,1,0
DeSean Jackson,36,7,1,17,9,153,17,0,5,62,1.3,21.9,0.529,9,0,0,0,0,0,0,0,0,9,17,153,0,0
Royce Freeman,26,4,1,8,6,33,5.5,0,0,9,1.5,8.3,0.75,4.1,41,117,0,7,11,2.9,29.3,10.3,47,3.2,150,0,1
Hassan Haskins,23,15,1,12,11,57,5.2,0,2,10,0.7,3.8,0.917,4.8,25,93,0,5,12,3.7,6.2,1.7,36,4.2,150,0,0
Zach Pascal,28,17,2,19,15,150,10,1,9,34,0.9,8.8,0.789,7.9,1,0,0,0,0,0,0,0.1,16,9.4,150,1,0
MyCole Pruitt,30,13,4,21,16,150,9.4,4,10,29,1.2,11.5,0.762,7.1,0,0,0,0,0,0,0,0,16,9.4,150,4,0
Josh Oliver,25,17,9,25,14,149,10.6,2,7,40,0.8,8.8,0.56,6,0,0,0,0,0,0,0,0,14,10.6,149,2,0
Eric Saubert,28,17,6,24,15,148,9.9,1,6,25,0.9,8.7,0.625,6.2,0,0,0,0,0,0,0,0,15,9.9,148,1,0
O.J. Howard,28,13,10,23,10,145,14.5,2,6,26,0.8,11.2,0.435,6.3,0,0,0,0,0,0,0,0,10,14.5,145,2,0
Cedrick Wilson Jr.,27,15,0,18,12,136,11.3,0,8,21,0.8,9.1,0.667,7.6,1,8,0,0,8,8,0.5,0.1,13,11.1,144,0,0
Pierre Strong,24,15,0,7,7,42,6,0,3,16,0.5,2.8,1,6,10,100,1,5,44,10,6.7,0.7,17,8.4,142,1,0
Keelan Cole,29,14,3,21,10,141,14.1,1,8,30,0.7,10.1,0.476,6.7,0,0,0,0,0,0,0,0,10,14.1,141,1,1
Tom Kennedy,26,7,1,15,8,141,17.6,0,7,44,1.1,20.1,0.533,9.4,0,0,0,0,0,0,0,0,8,17.6,141,0,0
Johnny Mundt,28,17,12,21,19,140,7.4,1,9,17,1.1,8.2,0.905,6.7,0,0,0,0,0,0,0,0,19,7.4,140,1,0
Mitchell Wilcox,26,16,4,18,17,139,8.2,1,6,19,1.1,8.7,0.944,7.7,0,0,0,0,0,0,0,0,17,8.2,139,1,0
Dan Arnold,27,17,0,13,9,135,15,0,5,26,0.5,7.9,0.692,10.4,0,0,0,0,0,0,0,0,9,15,135,0,0
Byron Pringle,29,11,4,16,10,135,13.5,2,8,35,0.9,12.3,0.625,8.4,0,0,0,0,0,0,0,0,10,13.5,135,2,0
Jeff Smith,25,11,0,11,8,134,16.8,0,5,50,0.7,12.2,0.727,12.2,0,0,0,0,0,0,0,0,8,16.8,134,0,0
Zach Gentry,26,17,13,23,19,132,6.9,0,6,32,1.1,7.8,0.826,5.7,0,0,0,0,0,0,0,0,19,6.9,132,0,0
Tanner Hudson,28,11,0,15,10,132,13.2,0,8,27,0.9,12,0.667,8.8,0,0,0,0,0,0,0,0,10,13.2,132,0,0
Donald Parham,25,6,1,12,10,130,13,1,5,24,1.7,21.7,0.833,10.8,0,0,0,0,0,0,0,0,10,13,130,1,0
Durham Smythe,27,16,15,20,15,129,8.6,1,7,26,0.9,8.1,0.75,6.5,2,1,1,1,1,0.5,0.1,0.1,17,7.6,130,2,0
Jalen Reagor,23,17,0,13,8,104,13,1,5,38,0.5,6.1,0.615,8,4,25,0,1,17,6.3,1.5,0.2,12,10.8,129,1,4
Brevin Jordan,22,11,3,28,14,128,9.1,0,7,20,1.3,11.6,0.5,4.6,0,0,0,0,0,0,0,0,14,9.1,128,0,0
Brandon Bolden,32,16,0,9,9,57,6.3,1,2,18,0.6,3.6,1,6.3,17,66,0,3,12,3.9,4.1,1.1,26,4.7,123,1,0
Jack Stoll,24,17,11,14,11,123,11.2,0,5,26,0.6,7.2,0.786,8.8,0,0,0,0,0,0,0,0,11,11.2,123,0,0
T.Y. Hilton,33,3,0,10,7,121,17.3,0,5,52,2.3,40.3,0.7,12.1,0,0,0,0,0,0,0,0,7,17.3,121,0,0
Malcolm Brown,29,11,0,6,5,37,7.4,0,2,13,0.5,3.4,0.833,6.2,18,81,1,3,23,4.5,7.4,1.6,23,5.1,118,1,0
Lawrence Cager,25,7,4,19,13,118,9.1,1,8,20,1.9,16.9,0.684,6.2,0,0,0,0,0,0,0,0,13,9.1,118,1,0
Pharaoh Brown,28,16,8,20,12,117,9.8,0,6,30,0.8,7.3,0.6,5.9,0,0,0,0,0,0,0,0,12,9.8,117,0,0
N'Keal Harry,25,7,0,9,7,116,16.6,1,4,49,1,16.6,0.778,12.9,0,0,0,0,0,0,0,0,7,16.6,116,1,0
Josiah Deguara,25,17,3,15,13,114,8.8,0,4,25,0.8,6.7,0.867,7.6,0,0,0,0,0,0,0,0,13,8.8,114,0,0
James Mitchell,23,14,0,11,11,113,10.3,1,7,22,0.8,8.1,1,10.3,0,0,0,0,0,0,0,0,11,10.3,113,1,0
Teagan Quitoriano,22,9,6,14,7,113,16.1,2,5,52,0.8,12.6,0.5,8.1,0,0,0,0,0,0,0,0,7,16.1,113,2,0
Darrel Williams,27,6,0,8,4,9,2.3,0,0,6,0.7,1.5,0.5,1.1,21,102,1,8,30,4.9,17,3.5,25,4.4,111,1,0
Corey Clement,28,9,1,7,5,54,10.8,0,3,21,0.6,6,0.714,7.7,15,55,1,6,12,3.7,6.1,1.7,20,5.5,109,1,0
Brycen Hopkins,25,14,1,11,7,109,15.6,0,5,22,0.5,7.8,0.636,9.9,0,0,0,0,0,0,0,0,7,15.6,109,0,0
John Bates,25,16,7,22,14,108,7.7,1,4,20,0.9,6.8,0.636,4.9,0,0,0,0,0,0,0,0,14,7.7,108,1,1
Jody Fortson,27,13,1,13,9,108,12,2,6,40,0.7,8.3,0.692,8.3,0,0,0,0,0,0,0,0,9,12,108,2,1
Anthony Schwartz,22,11,1,10,4,51,12.8,0,2,19,0.4,4.6,0.4,5.1,4,57,1,2,31,14.3,5.2,0.4,8,13.5,108,1,1
Benny Snell Jr.,24,17,0,2,2,17,8.5,0,1,11,0.1,1,1,8.5,20,90,1,6,16,4.5,5.3,1.2,22,4.9,107,1,0
David Sills,26,9,5,17,11,106,9.6,0,7,24,1.2,11.8,0.647,6.2,0,0,0,0,0,0,0,0,11,9.6,106,0,0
Ross Dwelley,27,12,0,5,3,105,35,1,3,56,0.3,8.8,0.6,21,0,0,0,0,0,0,0,0,3,35,105,1,0
Peyton Hendershot,23,17,2,16,11,103,9.4,2,8,29,0.6,6.1,0.688,6.4,1,2,1,1,2,2,0.1,0.1,12,8.8,105,3,1
Breshad Perriman,29,11,3,19,9,110,12.2,1,5,28,0.8,10,0.474,5.8,2,-7,0,0,0,-3.5,-0.6,0.2,11,9.4,103,1,2
River Cracraft,28,11,0,14,9,102,11.3,2,8,22,0.8,9.3,0.643,7.3,0,0,0,0,0,0,0,0,9,11.3,102,2,0
Anthony Firkser,27,11,1,13,9,100,11.1,0,5,22,0.8,9.1,0.692,7.7,0,0,0,0,0,0,0,0,9,11.1,100,0,0
Giovanni Ricci,26,15,3,9,8,100,12.5,0,3,32,0.5,6.7,0.889,11.1,0,0,0,0,0,0,0,0,8,12.5,100,0,0
Tyrion Davis-Price,22,6,0,2,0,0,0,0,0,0,0,0,0,0,34,99,0,5,20,2.9,16.5,5.7,34,2.9,99,0,0
Marcus Johnson,28,14,7,22,9,99,11,0,6,18,0.6,7.1,0.409,4.5,0,0,0,0,0,0,0,0,9,11,99,0,0
Darrynton Evans,24,6,0,1,1,33,33,0,1,33,0.2,5.5,1,33,14,64,0,3,21,4.6,10.7,2.3,15,6.5,97,0,0
Albert Okwuegbunam,24,8,1,18,10,95,9.5,1,4,25,1.3,11.9,0.556,5.3,0,0,0,0,0,0,0,0,10,9.5,95,1,0
Ronald Jones II,25,6,0,1,1,22,22,0,1,22,0.2,3.7,1,22,17,70,1,4,13,4.1,11.7,2.8,18,5.1,92,1,0
Gunner Olszewski,26,16,2,7,5,53,10.6,0,1,31,0.3,3.3,0.714,7.6,8,39,0,3,18,4.9,2.4,0.5,13,7.1,92,0,2
Armani Rogers,25,11,3,6,5,64,12.8,0,4,23,0.5,5.8,0.833,10.7,2,26,0,1,24,13,2.4,0.2,7,12.9,90,0,0
Michael Bandy,25,10,2,21,10,89,8.9,0,5,25,1,8.9,0.476,4.2,0,0,0,0,0,0,0,0,10,8.9,89,0,0
Parker Hesse,27,17,7,11,9,89,9.9,0,6,22,0.5,5.2,0.818,8.1,0,0,0,0,0,0,0,0,9,9.9,89,0,0
Cam Sims,26,17,3,18,8,89,11.1,0,5,21,0.5,5.2,0.444,4.9,0,0,0,0,0,0,0,0,8,11.1,89,0,0
Jordan Wilkins,28,4,0,8,6,29,4.8,0,1,10,1.5,7.3,0.75,3.6,13,58,0,2,9,4.5,14.5,3.3,19,4.6,87,0,0
Quintin Morris,23,14,1,11,8,84,10.5,1,6,26,0.6,6,0.727,7.6,0,0,0,0,0,0,0,0,8,10.5,84,1,1
Samori Toure,24,11,2,10,5,82,16.4,1,2,37,0.5,7.5,0.5,8.2,0,0,0,0,0,0,0,0,5,16.4,82,1,1
Grant Calcaterra,24,15,2,9,5,81,16.2,0,3,40,0.3,5.4,0.556,9,0,0,0,0,0,0,0,0,5,16.2,81,0,0
Kenny Golladay,29,12,4,17,6,81,13.5,1,4,25,0.5,6.8,0.353,4.8,0,0,0,0,0,0,0,0,6,13.5,81,1,0
Keaontay Ingram,23,12,0,5,4,21,5.3,0,1,24,0.3,1.8,0.8,4.2,27,60,1,4,13,2.2,5,2.3,31,2.6,81,1,0
Jameson Williams,21,6,0,9,1,41,41,1,1,41,0.2,6.8,0.111,4.6,1,40,0,1,40,40,6.7,0.2,2,40.5,81,1,0
Ko Kieft,24,17,12,10,7,80,11.4,1,5,19,0.4,4.7,0.7,8,0,0,0,0,0,0,0,0,7,11.4,80,1,0
Eric Tomlinson,30,17,12,13,9,79,8.8,2,5,18,0.5,4.6,0.692,6.1,0,0,0,0,0,0,0,0,9,8.8,79,2,0
Jaret Patterson,23,3,0,1,0,0,0,0,0,0,0,0,0,0,17,78,0,3,14,4.6,26,5.7,17,4.6,78,0,0
Kyle Philips,23,4,0,13,8,78,9.8,0,3,21,2,19.5,0.615,6,0,0,0,0,0,0,0,0,8,9.8,78,0,2
Trent Taylor,28,16,1,10,6,62,10.3,0,1,34,0.4,3.9,0.6,6.2,4,15,0,0,9,3.8,0.9,0.3,10,7.7,77,0,2
Jalen Virgil,24,9,1,5,2,75,37.5,1,2,66,0.2,8.3,0.4,15,0,0,0,0,0,0,0,0,2,37.5,75,1,1
Kevin White,30,7,2,5,2,74,37,0,2,64,0.3,10.6,0.4,14.8,0,0,0,0,0,0,0,0,2,37,74,0,0
Salvon Ahmed,24,12,0,1,1,8,8,0,0,8,0.1,0.7,1,8,12,64,1,4,11,5.3,5.3,1,13,5.5,72,1,0
Tre' McKitty,23,17,8,18,10,72,7.2,0,0,12,0.6,4.2,0.556,4,0,0,0,0,0,0,0,0,10,7.2,72,0,1
Ke'Shawn Vaughn,25,15,0,4,3,19,6.3,0,1,11,0.2,1.3,0.75,4.8,17,53,0,3,12,3.1,3.5,1.1,20,3.6,72,0,0
David Johnson,31,5,0,4,4,47,11.8,0,3,21,0.8,9.4,1,11.8,12,24,0,0,5,2,4.8,2.4,16,4.4,71,0,1
Tevin Coleman,29,5,0,3,3,44,14.7,1,2,30,0.6,8.8,1,14.7,12,26,1,2,14,2.2,5.2,2.4,15,4.7,70,2,0
Zamir White,23,14,0,0,0,0,0,0,0,0,0,0,0,0,17,70,0,4,22,4.1,5,1.2,17,4.1,70,0,0
D'Wayne Eskridge,25,10,0,13,7,58,8.3,0,4,16,0.7,5.8,0.538,4.5,2,10,0,0,6,5,1,0.2,9,7.6,68,0,0
Phillip Lindsay,28,3,0,8,6,19,3.2,0,0,7,2,6.3,0.75,2.4,15,49,0,1,15,3.3,16.3,5,21,3.2,68,0,0
Marcedes Lewis,38,17,17,7,6,66,11,2,5,31,0.4,3.9,0.857,9.4,0,0,0,0,0,0,0,0,6,11,66,2,0
Jalen Guyton,25,3,0,4,2,64,32,0,2,54,0.7,21.3,0.5,16,0,0,0,0,0,0,0,0,2,32,64,0,0
Jake Kumerow,30,6,1,7,4,64,16,0,4,39,0.7,10.7,0.571,9.1,0,0,0,0,0,0,0,0,4,16,64,0,0
Trestan Ebner,23,17,0,8,2,8,4,0,0,6,0.1,0.5,0.25,1,24,54,0,2,11,2.3,3.2,1.4,26,2.4,62,0,2
James Proche,26,15,0,17,8,62,7.8,0,3,12,0.5,4.1,0.471,3.6,0,0,0,0,0,0,0,0,8,7.8,62,0,0
Jamison Crowder,29,4,0,13,6,60,10,0,4,16,1.5,15,0.462,4.6,0,0,0,0,0,0,0,0,6,10,60,0,1
Trayveon Williams,25,8,0,3,2,30,15,0,1,24,0.3,3.8,0.667,10,6,30,0,1,16,5,3.8,0.8,8,7.5,60,0,0
Shane Zylstra,26,13,2,15,11,60,5.5,4,6,14,0.8,4.6,0.733,4,0,0,0,0,0,0,0,0,11,5.5,60,4,0
Mike Strachan,25,13,0,9,3,59,19.7,0,3,23,0.2,4.5,0.333,6.6,0,0,0,0,0,0,0,0,3,19.7,59,0,0
Geoff Swaim,29,17,13,16,12,58,4.8,1,4,13,0.7,3.4,0.75,3.6,0,0,0,0,0,0,0,0,12,4.8,58,1,0
Deven Thompkins,23,5,1,10,5,32,6.4,0,1,13,1,6.4,0.5,3.2,2,26,0,1,17,13,5.2,0.4,7,8.3,58,0,1
Tyler Kroft,30,11,4,5,4,57,14.3,0,2,28,0.4,5.2,0.8,11.4,0,0,0,0,0,0,0,0,4,14.3,57,0,0
Myles Gaskin,25,4,0,6,4,28,7,0,0,16,1,7,0.667,4.7,10,26,0,2,10,2.6,6.5,2.5,14,3.9,54,0,0
Cody Hollister,29,11,3,5,3,54,18,0,2,27,0.3,4.9,0.6,10.8,0,0,0,0,0,0,0,0,3,18,54,0,0
Tony Jones,25,6,0,8,5,30,6,0,0,9,0.8,5,0.625,3.8,10,24,0,3,7,2.4,4,1.7,15,3.6,54,0,0
Isaiah Spiller,21,6,0,3,3,13,4.3,0,0,8,0.5,2.2,1,4.3,18,41,0,2,11,2.3,6.8,3,21,2.6,54,0,0
Spencer Brown,24,2,0,4,2,10,5,0,0,9,1,5,0.5,2.5,9,43,0,1,7,4.8,21.5,4.5,11,4.8,53,0,0
Julius Chestnut,22,6,0,3,3,41,13.7,0,1,33,0.5,6.8,1,13.7,9,12,0,1,5,1.3,2,1.5,12,4.4,53,0,0
Kevin Harris,22,5,1,0,0,0,0,0,0,0,0,0,0,0,18,52,1,3,14,2.9,10.4,3.6,18,2.9,52,1,0
Ronnie Rivers,23,8,1,5,5,29,5.8,0,1,14,0.6,3.6,1,5.8,9,21,0,1,5,2.3,2.6,1.1,14,3.6,50,0,0
Charlie Kolar,23,2,0,6,4,49,12.3,0,3,15,2,24.5,0.667,8.2,0,0,0,0,0,0,0,0,4,12.3,49,0,0
Patrick Taylor,24,14,0,1,1,17,17,0,1,17,0.1,1.2,1,17,10,31,0,2,6,3.1,2.2,0.7,11,4.4,48,0,0
Chris Conley,30,9,1,7,4,46,11.5,0,2,27,0.4,5.1,0.571,6.6,0,0,0,0,0,0,0,0,4,11.5,46,0,0
Stephen Sullivan,26,14,0,6,2,46,23,0,2,33,0.1,3.3,0.333,7.7,0,0,0,0,0,0,0,0,2,23,46,0,0
Andre Baccellia,25,8,0,10,7,45,6.4,0,4,11,0.9,5.6,0.7,4.5,0,0,0,0,0,0,0,0,7,6.4,45,0,0
Dwayne Washington,28,12,0,1,1,7,7,0,0,7,0.1,0.6,1,7,11,38,0,2,8,3.5,3.2,0.9,12,3.8,45,0,0
Racey McMath,23,5,0,8,2,40,20,0,1,39,0.4,8,0.25,5,1,4,0,0,4,4,0.8,0.2,3,14.7,44,0,0
John Brown,32,3,0,2,1,42,42,1,1,42,0.3,14,0.5,21,0,0,0,0,0,0,0,0,1,42,42,1,0
Snoop Conner,22,8,0,0,0,0,0,0,0,0,0,0,0,0,12,42,1,2,8,3.5,5.3,1.5,12,3.5,42,1,0
Brandon Johnson,24,7,1,14,6,42,7,1,2,12,0.9,6,0.429,3,0,0,0,0,0,0,0,0,6,7,42,1,1
Chris Manhertz,30,17,11,8,6,42,7,0,2,21,0.4,2.5,0.75,5.3,0,0,0,0,0,0,0,0,6,7,42,0,0
Laquon Treadwell,27,6,0,10,6,42,7,0,3,17,1,7,0.6,4.2,0,0,0,0,0,0,0,0,6,7,42,0,0
Anthony McFarland Jr.,23,1,0,2,2,11,5.5,0,1,12,2,11,1,5.5,6,30,0,3,14,5,30,6,8,5.1,41,0,0
Luke Farrell,25,17,0,4,4,40,10,0,3,15,0.2,2.4,1,10,0,0,0,0,0,0,0,0,4,10,40,0,0
Michael Woods II,22,10,0,10,5,45,9,0,3,15,0.5,4.5,0.5,4.5,1,-5,0,0,-5,-5,-0.5,0.1,6,6.7,40,0,0
Chris Evans,25,12,0,4,3,38,12.7,1,2,26,0.3,3.2,0.75,9.5,0,0,0,0,0,0,0,0,3,12.7,38,1,0
Mike Thomas,28,10,2,10,2,38,19,0,1,33,0.2,3.8,0.2,3.8,0,0,0,0,0,0,0,0,2,19,38,0,0
Dax Milne,23,15,1,7,6,37,6.2,1,2,12,0.4,2.5,0.857,5.3,0,0,0,0,0,0,0,0,6,6.2,37,1,1
Kendall Blanton,27,4,0,2,2,35,17.5,0,1,28,0.5,8.8,1,17.5,0,0,0,0,0,0,0,0,2,17.5,35,0,0
Kene Nwangwu,24,17,0,2,2,21,10.5,0,1,16,0.1,1.2,1,10.5,9,14,0,1,8,1.6,0.8,0.5,11,3.2,35,0,0
Larry Rountree,23,4,0,2,2,14,7,0,1,13,0.5,3.5,1,7,13,19,0,0,5,1.5,4.8,3.3,15,2.2,33,0,0
Tylan Wallace,23,9,0,7,4,33,8.3,0,1,12,0.4,3.7,0.571,4.7,0,0,0,0,0,0,0,0,4,8.3,33,0,0
Montrell Washington,23,15,1,9,4,2,0.5,0,0,4,0.3,0.1,0.444,0.2,5,30,0,0,19,6,2,0.3,9,3.6,32,0,5
Tim Jones,24,17,1,4,3,30,10,0,1,20,0.2,1.8,0.75,7.5,0,0,0,0,0,0,0,0,3,10,30,0,0
Tyrie Cleveland,25,6,0,7,2,28,14,0,1,16,0.3,4.7,0.286,4,0,0,0,0,0,0,0,0,2,14,28,0,0
Kyle Rudolph,33,9,0,5,3,28,9.3,1,2,12,0.3,3.1,0.6,5.6,0,0,0,0,0,0,0,0,3,9.3,28,1,0
Giovani Bernard,31,8,0,2,2,-1,-0.5,0,0,6,0.3,-0.1,1,-0.5,8,28,0,0,8,3.5,3.5,1,10,2.7,27,0,1
Tyler Davis,25,17,1,7,4,26,6.5,0,1,23,0.2,1.5,0.571,3.7,0,0,0,0,0,0,0,0,4,6.5,26,0,0
Ben Ellefson,26,4,1,3,3,26,8.7,0,2,12,0.8,6.5,1,8.7,0,0,0,0,0,0,0,0,3,8.7,26,0,0
Ryan Griffin,32,15,0,8,4,26,6.5,0,1,18,0.3,1.7,0.5,3.3,0,0,0,0,0,0,0,0,4,6.5,26,0,0
DJ Turner,25,9,0,1,0,0,0,0,0,0,0,0,0,0,4,26,0,1,18,6.5,2.9,0.4,4,6.5,26,0,1
KaVontae Turpin*,26,17,0,2,1,9,9,0,0,9,0.1,0.5,0.5,4.5,3,17,0,1,11,5.7,1,0.2,4,6.5,26,0,3
Trevon Wesco,27,14,1,4,2,26,13,0,1,23,0.1,1.9,0.5,6.5,0,0,0,0,0,0,0,0,2,13,26,0,0
Daylen Baldwin,23,1,0,2,2,25,12.5,0,2,15,2,25,1,12.5,0,0,0,0,0,0,0,0,2,12.5,25,0,0
Tyler Badie,22,1,0,1,1,24,24,1,1,24,1,24,1,24,1,0,0,0,0,0,0,1,2,12,24,1,0
Simi Fehoko,25,5,0,4,3,24,8,0,1,12,0.6,4.8,0.75,6,0,0,0,0,0,0,0,0,3,8,24,0,0
D'Ernest Johnson,26,15,0,3,3,7,2.3,0,0,7,0.2,0.5,1,2.3,4,17,0,1,7,4.3,1.1,0.3,7,3.4,24,0,0
Dezmon Patmon,24,1,0,6,2,24,12,0,1,17,2,24,0.333,4,0,0,0,0,0,0,0,0,2,12,24,0,0
Dareke Young,23,13,0,2,2,24,12,0,2,12,0.2,1.8,1,12,0,0,0,0,0,0,0,0,2,12,24,0,0
Cole Turner,22,10,2,9,2,23,11.5,0,1,18,0.2,2.3,0.222,2.6,0,0,0,0,0,0,0,0,2,11.5,23,0,0
Mike Davis,29,8,0,2,2,4,2,0,0,7,0.3,0.5,1,2,8,18,0,1,10,2.3,2.3,1,10,2.2,22,0,1
Pharoh Cooper,27,5,1,2,2,6,3,0,0,3,0.4,1.2,1,3,4,15,0,0,6,3.8,3,0.8,6,3.5,21,0,0
Cade Johnson,24,3,0,4,2,21,10.5,0,2,11,0.7,7,0.5,5.3,0,0,0,0,0,0,0,0,2,10.5,21,0,0
Blake Bell,31,3,1,2,2,20,10,1,1,17,0.7,6.7,1,10,0,0,0,0,0,0,0,0,2,10,20,1,0
Ty Chandler,24,3,0,0,0,0,0,0,0,0,0,0,0,0,6,20,0,1,10,3.3,6.7,2,6,3.3,20,0,0
Keke Coutee,25,8,0,1,1,20,20,0,0,20,0.1,2.5,1,20,0,0,0,0,0,0,0,0,1,20,20,0,4
Penny Hart,26,9,0,4,3,20,6.7,0,1,15,0.3,2.2,0.75,5,0,0,0,0,0,0,0,0,3,6.7,20,0,0
Lil'Jordan Humphrey,24,6,2,4,2,20,10,0,0,11,0.3,3.3,0.5,5,0,0,0,0,0,0,0,0,2,10,20,0,0
Danny Gray,23,13,0,7,1,10,10,0,1,10,0.1,0.8,0.143,1.4,1,9,0,0,9,9,0.7,0.1,2,9.5,19,0,0
Jesper Horsted,25,15,0,4,3,19,6.3,0,0,9,0.2,1.3,0.75,4.8,0,0,0,0,0,0,0,0,3,6.3,19,0,0
Trey Sermon,23,2,0,0,0,0,0,0,0,0,0,0,0,0,2,19,0,2,14,9.5,9.5,1,2,9.5,19,0,0
Keith Kirkwood,28,5,1,4,2,18,9,0,1,14,0.4,3.6,0.5,4.5,0,0,0,0,0,0,0,0,2,9,18,0,0
Maxx Williams,28,11,1,3,3,18,6,0,0,7,0.3,1.6,1,6,0,0,0,0,0,0,0,0,3,6,18,0,0
Braylon Sanders,23,3,0,3,2,17,8.5,0,0,13,0.7,5.7,0.667,5.7,0,0,0,0,0,0,0,0,2,8.5,17,0,1
Stone Smartt,24,7,1,5,4,17,4.3,0,1,8,0.6,2.4,0.8,3.4,0,0,0,0,0,0,0,0,4,4.3,17,0,0
J.J. Taylor,24,1,0,1,1,8,8,0,0,8,1,8,1,8,10,9,0,0,5,0.9,9,10,11,1.5,17,0,0
Juwann Winfree,26,3,0,4,1,17,17,0,1,17,0.3,5.7,0.25,4.3,0,0,0,0,0,0,0,0,1,17,17,0,0
Dennis Houston,23,2,0,6,2,16,8,0,0,11,1,8,0.333,2.7,0,0,0,0,0,0,0,0,2,8,16,0,0
Quintez Cephus,24,4,1,3,2,15,7.5,0,1,9,0.5,3.8,0.667,5,0,0,0,0,0,0,0,0,2,7.5,15,0,0
Frank Darby,25,5,0,1,1,15,15,0,1,15,0.2,3,1,15,0,0,0,0,0,0,0,0,1,15,15,0,0
Bryan Edwards,24,7,1,5,3,15,5,0,0,10,0.4,2.1,0.6,3,0,0,0,0,0,0,0,0,3,5,15,0,0
Nsimba Webster,26,2,0,3,2,14,7,0,1,8,1,7,0.667,4.7,0,0,0,0,0,0,0,0,2,7,14,0,1
Deonte Harty,25,4,0,2,2,13,6.5,0,0,9,0.5,3.3,1,6.5,0,0,0,0,0,0,0,0,2,6.5,13,0,1
Ty Montgomery,29,1,0,4,3,15,5,1,1,7,3,15,0.75,3.8,2,-2,0,0,0,-1,-2,2,5,2.6,13,1,0
Austin Trammell,24,6,0,4,2,13,6.5,0,1,8,0.3,2.2,0.5,3.3,0,0,0,0,0,0,0,0,2,6.5,13,0,0
Jerome Ford,23,13,0,0,0,0,0,0,0,0,0,0,0,0,8,12,0,1,9,1.5,0.9,0.6,8,1.5,12,0,0
Jalen Tolbert,23,8,1,3,2,12,6,0,0,8,0.3,1.5,0.667,4,0,0,0,0,0,0,0,0,2,6,12,0,0
Miles Boykin,26,16,1,3,2,11,5.5,0,1,11,0.1,0.7,0.667,3.7,0,0,0,0,0,0,0,0,2,5.5,11,0,0
Sean McKeon,25,13,0,3,2,11,5.5,0,1,10,0.2,0.8,0.667,3.7,0,0,0,0,0,0,0,0,2,5.5,11,0,0
Stephen Anderson,29,16,0,7,3,9,3,0,0,6,0.2,0.6,0.429,1.3,0,0,0,0,0,0,0,0,3,3,9,0,0
Reggie Bonnafon,26,1,0,0,0,0,0,0,0,0,0,0,0,0,3,8,0,0,5,2.7,8,3,3,2.7,8,0,0
Tyron Johnson,26,4,1,1,1,8,8,0,0,8,0.3,2,1,8,0,0,0,0,0,0,0,0,1,8,8,0,0
Jeremy Ruckert,22,9,0,2,1,8,8,0,0,8,0.1,0.9,0.5,4,0,0,0,0,0,0,0,0,1,8,8,0,0
Maurice Alexander,25,4,0,1,1,7,7,0,0,7,0.3,1.8,1,7,0,0,0,0,0,0,0,0,1,7,7,0,0
Jalen Camp,24,2,0,1,1,7,7,0,1,7,0.5,3.5,1,7,0,0,0,0,0,0,0,0,1,7,7,0,0
Kylin Hill,24,2,0,0,0,0,0,0,0,0,0,0,0,0,1,7,0,1,7,7,3.5,0.5,1,7,7,0,0
Godwin Igwebuike,28,5,0,1,1,3,3,0,0,3,0.2,0.6,1,3,3,4,0,0,4,1.3,0.8,0.6,4,1.8,7,0,0
Tyler Mabry,26,2,0,1,1,7,7,1,1,7,0.5,3.5,1,7,0,0,0,0,0,0,0,0,1,7,7,1,0
Devine Ozigbo,26,4,0,1,1,3,3,0,0,3,0.3,0.8,1,3,3,4,0,0,4,1.3,1,0.8,4,1.8,7,0,0
Tommy Sweeney,27,5,0,1,1,7,7,0,1,7,0.2,1.4,1,7,0,0,0,0,0,0,0,0,1,7,7,0,0
C.J. Board,29,4,0,1,1,6,6,0,0,6,0.3,1.5,1,6,0,0,0,0,0,0,0,0,1,6,6,0,1
Jacob Harris,25,7,0,1,1,6,6,0,1,6,0.1,0.9,1,6,0,0,0,0,0,0,0,0,1,6,6,0,0
Mason Schreck,29,3,1,2,2,6,3,0,0,6,0.7,2,1,3,0,0,0,0,0,0,0,0,2,3,6,0,0
Devin Asiasi,25,12,0,4,2,5,2.5,0,0,6,0.2,0.4,0.5,1.3,0,0,0,0,0,0,0,0,2,2.5,5,0,0
Jason Moore,27,6,0,2,1,5,5,0,0,5,0.2,0.8,0.5,2.5,0,0,0,0,0,0,0,0,1,5,5,0,0
Ty'Son Williams,26,1,0,1,1,5,5,0,0,5,1,5,1,5,0,0,0,0,0,0,0,0,1,5,5,0,0
Demetric Felton,24,8,2,4,2,8,4,0,0,5,0.3,1,0.5,2,1,-4,0,0,-4,-4,-0.5,0.1,3,1.3,4,0,1
Duke Johnson,29,1,0,0,0,0,0,0,0,0,0,0,0,0,2,4,0,1,4,2,4,2,2,2,4,0,0
Richard Rodgers,30,10,1,4,1,4,4,0,0,4,0.1,0.4,0.25,1,0,0,0,0,0,0,0,0,1,4,4,0,0
Erik Ezukanma,22,1,0,1,1,3,3,0,0,3,1,3,1,3,0,0,0,0,0,0,0,0,1,3,3,0,0
Mason Kinsey,24,2,0,1,1,3,3,0,0,3,0.5,1.5,1,3,0,0,0,0,0,0,0,0,1,3,3,0,1
Cody White,24,1,1,1,1,2,2,0,0,2,1,2,1,2,0,0,0,0,0,0,0,0,1,2,2,0,0
Damien Williams,30,1,1,0,0,0,0,0,0,0,0,0,0,0,2,2,0,0,2,1,2,2,2,1,2,0,0
Jordan Howard,28,2,0,0,0,0,0,0,0,0,0,0,0,0,1,1,0,0,1,1,0.5,0.5,1,1,1,0,0
