Name,Points,Unnamed: 1_level_0Age,GamesG,GamesGS,RushingRush,RushingYds,RushingTD,Rushing1D,RushingLng,RushingY/A,RushingY/G,RushingA/G,ReceivingTgt,ReceivingRec,ReceivingYds,ReceivingY/R,ReceivingTD,Receiving1D,ReceivingLng,ReceivingR/G,ReceivingY/G,ReceivingCtch%,ReceivingY/Tgt,Total YdsTouch,Total YdsY/Tch,Total YdsYScm,Unnamed: 29_level_0RRTD,Unnamed: 30_level_0Fmb
Josh Jacobs,491.9,21,13,13,242,1150,7,53,51,4.8,88.5,18.6,27,20,166,8.3,0,8,28,1.5,12.8,0.741,6.1,262,5,1316,7,1
Josh Jacobs,470,22,15,15,273,1065,12,61,28,3.9,71,18.2,45,33,238,7.2,0,9,29,2.2,15.9,0.733,5.3,306,4.3,1303,12,2
Josh Jacobs,734.9,23,15,14,217,872,9,45,28,4,58.1,14.5,64,54,348,6.4,0,14,29,3.6,23.2,0.844,5.4,271,4.5,1220,9,2
Derrick Henry,309,22,15,2,110,490,5,29,22,4.5,32.7,7.3,15,13,137,10.5,0,5,29,0.9,9.1,0.867,9.1,123,5.1,627,5,0
Derrick Henry,432.4,23,16,2,176,744,5,40,75,4.2,46.5,11,17,11,136,12.4,1,4,66,0.7,8.5,0.647,8,187,4.7,880,6,1
Derrick Henry,639.8,24,16,12,215,1059,12,50,99,4.9,66.2,13.4,18,15,99,6.6,0,4,21,0.9,6.2,0.833,5.5,230,5,1158,12,1
Derrick Henry,757.3,25,15,15,303,1540,16,73,74,5.1,102.7,20.2,24,18,206,11.4,2,4,75,1.2,13.7,0.75,8.6,321,5.4,1746,18,5
Derrick Henry,403.3,26,16,16,378,2027,17,98,94,5.4,126.7,23.6,31,19,114,6,0,4,53,1.2,7.1,0.613,3.7,397,5.4,2141,17,3
Derrick Henry,679.8,27,8,8,219,937,10,49,76,4.3,117.1,27.4,20,18,154,8.6,0,7,16,2.3,19.3,0.9,7.7,237,4.6,1091,10,1
Christian McCaffrey,766.5,21,16,10,117,435,2,22,40,3.7,27.2,7.3,113,80,651,8.1,5,37,37,5,40.7,0.708,5.8,197,5.5,1086,7,2
Christian McCaffrey,945.6,22,16,16,219,1098,7,53,59,5,68.6,13.7,124,107,867,8.1,6,41,38,6.7,54.2,0.863,7,326,6,1965,13,4
Christian McCaffrey,165.2,23,16,16,287,1387,15,57,84,4.8,86.7,17.9,142,116,1005,8.7,4,58,28,7.3,62.8,0.817,7.1,403,5.9,2392,19,1
Christian McCaffrey,282.5,24,3,3,59,225,5,14,15,3.8,75,19.7,19,17,149,8.8,1,8,24,5.7,49.7,0.895,7.8,76,4.9,374,6,0
Christian McCaffrey,725,25,7,7,99,442,1,20,18,4.5,63.1,14.1,41,37,343,9.3,1,21,32,5.3,49,0.902,8.4,136,5.8,785,2,1
Justin Jefferson,655,21,16,14,1,2,0,0,2,2,0.1,0.1,125,88,1400,15.9,7,58,71,5.5,87.5,0.704,11.2,89,15.8,1402,7,1
Justin Jefferson,731.9,22,17,17,6,14,0,1,11,2.3,0.8,0.4,167,108,1616,15,10,75,56,6.4,95.1,0.647,9.7,114,14.3,1630,10,1
Nick Chubb,609.6,23,16,9,192,996,8,47,92,5.2,62.3,12,29,20,149,7.5,2,5,24,1.3,9.3,0.69,5.1,212,5.4,1145,10,0
Nick Chubb,451.1,24,16,16,298,1494,8,62,88,5,93.4,18.6,49,36,278,7.7,0,13,32,2.3,17.4,0.735,5.7,334,5.3,1772,8,3
Nick Chubb,499.9,25,12,12,190,1067,12,56,59,5.6,88.9,15.8,18,16,150,9.4,0,6,26,1.3,12.5,0.889,8.3,206,5.9,1217,12,1
Nick Chubb,632.2,26,14,14,228,1259,8,61,70,5.5,89.9,16.3,25,20,174,8.7,1,9,40,1.4,12.4,0.8,7,248,5.8,1433,9,2
Tyreek Hill,485.6,22,16,1,24,267,3,11,70,11.1,16.7,1.5,83,61,593,9.7,6,31,49,3.8,37.1,0.735,7.1,85,10.1,860,9,4
Tyreek Hill,654,23,15,13,17,59,0,3,16,3.5,3.9,1.1,105,75,1183,15.8,7,40,79,5,78.9,0.714,11.3,92,13.5,1242,7,2
Tyreek Hill,364.9,24,16,16,22,151,1,7,33,6.9,9.4,1.4,137,87,1479,17,12,60,75,5.4,92.4,0.635,10.8,109,15,1630,13,0
Tyreek Hill,606.7,25,12,12,8,23,0,1,5,2.9,1.9,0.7,89,58,860,14.8,7,39,57,4.8,71.7,0.652,9.7,66,13.4,883,7,0
Tyreek Hill,561.5,26,15,15,13,123,2,5,32,9.5,8.2,0.9,135,87,1276,14.7,15,57,75,5.8,85.1,0.644,9.5,100,14,1399,17,1
Tyreek Hill,687.6,27,17,16,9,96,0,4,33,10.7,5.6,0.5,159,111,1239,11.2,9,75,75,6.5,72.9,0.698,7.8,120,11.1,1335,9,2
Saquon Barkley,530.3,21,16,16,261,1307,11,50,78,5,81.7,16.3,121,91,721,7.9,4,30,57,5.7,45.1,0.752,6,352,5.8,2028,15,0
Saquon Barkley,34.2,22,13,13,217,1003,6,45,68,4.6,77.2,16.7,73,52,438,8.4,2,14,65,4,33.7,0.712,6,269,5.4,1441,8,1
Saquon Barkley,317.8,23,2,2,19,34,0,1,18,1.8,17,9.5,9,6,60,10,0,3,38,3,30,0.667,6.7,25,3.8,94,0,0
Saquon Barkley,610,24,13,13,162,593,2,27,41,3.7,45.6,12.5,57,41,263,6.4,2,13,54,3.2,20.2,0.719,4.6,203,4.2,856,4,2
Austin Ekeler,360.4,22,16,0,47,260,2,13,35,5.5,16.3,2.9,35,27,279,10.3,3,12,38,1.7,17.4,0.771,8,74,7.3,539,5,2
Austin Ekeler,617,23,14,3,106,554,3,25,41,5.2,39.6,7.6,53,39,404,10.4,3,18,44,2.8,28.9,0.736,7.6,145,6.6,958,6,1
Austin Ekeler,349.9,24,16,8,132,557,3,32,35,4.2,34.8,8.3,108,92,993,10.8,8,42,84,5.8,62.1,0.852,9.2,224,6.9,1550,11,3
Austin Ekeler,649.4,25,10,10,116,530,1,26,27,4.6,53,11.6,65,54,403,7.5,2,20,28,5.4,40.3,0.831,6.2,170,5.5,933,3,1
Austin Ekeler,696.1,26,16,16,206,911,12,53,28,4.4,56.9,12.9,94,70,647,9.2,8,31,40,4.4,40.4,0.745,6.9,276,5.6,1558,20,4
Aaron Jones,358.2,23,12,4,81,448,4,23,46,5.5,37.3,6.8,18,9,22,2.4,0,2,9,0.8,1.8,0.5,1.2,90,5.2,470,4,0
Aaron Jones,624.4,24,12,8,133,728,8,41,67,5.5,60.7,11.1,35,26,206,7.9,1,12,24,2.2,17.2,0.743,5.9,159,5.9,934,9,1
Aaron Jones,546.7,25,16,16,236,1084,16,55,56,4.6,67.8,14.8,68,49,474,9.7,3,18,67,3.1,29.6,0.721,7,285,5.5,1558,19,3
Aaron Jones,465,26,14,14,201,1104,9,52,77,5.5,78.9,14.4,63,47,355,7.6,2,15,30,3.4,25.4,0.746,5.6,248,5.9,1459,11,2
Aaron Jones,545.8,27,15,15,171,799,4,37,57,4.7,53.3,11.4,65,52,391,7.5,6,22,26,3.5,26.1,0.8,6,223,5.3,1190,10,2
Davante Adams,200.9,22,16,11,0,0,0,0,0,0,0,0,66,38,446,11.7,3,23,45,2.4,27.9,0.576,6.8,38,11.7,446,3,0
Davante Adams,442.1,23,13,12,0,0,0,0,0,0,0,0,94,50,483,9.7,1,20,40,3.8,37.2,0.532,5.1,50,9.7,483,1,0
Davante Adams,399.5,24,16,15,0,0,0,0,0,0,0,0,121,75,997,13.3,12,46,66,4.7,62.3,0.62,8.2,75,13.3,997,12,2
Davante Adams,604.8,25,14,14,0,0,0,0,0,0,0,0,117,74,885,12,10,46,55,5.3,63.2,0.632,7.6,74,12,885,10,0
Davante Adams,408.1,26,15,15,0,0,0,0,0,0,0,0,169,111,1386,12.5,13,64,57,7.4,92.4,0.657,8.2,111,12.5,1386,13,0
Davante Adams,633.2,27,12,12,0,0,0,0,0,0,0,0,127,83,997,12,5,54,58,6.9,83.1,0.654,7.9,83,12,997,5,2
Davante Adams,654.9,28,14,14,0,0,0,0,0,0,0,0,149,115,1374,11.9,18,73,56,8.2,98.1,0.772,9.2,115,11.9,1374,18,1
Davante Adams,636.5,29,16,16,0,0,0,0,0,0,0,0,169,123,1553,12.6,11,84,59,7.7,97.1,0.728,9.2,123,12.6,1553,11,0
A.J. Brown,454.5,22,16,11,3,60,1,2,49,20,3.8,0.2,84,52,1051,20.2,8,39,91,3.3,65.7,0.619,12.5,55,20.2,1111,9,1
A.J. Brown,356.7,23,14,12,0,0,0,0,0,0,0,0,106,70,1075,15.4,11,55,73,5,76.8,0.66,10.1,70,15.4,1075,11,2
A.J. Brown,598.8,24,13,13,2,10,0,1,7,5,0.8,0.2,105,63,869,13.8,5,45,57,4.8,66.8,0.6,8.3,65,13.5,879,5,0
Dalvin Cook,336,22,4,4,74,354,2,16,33,4.8,88.5,18.5,16,11,90,8.2,0,3,36,2.8,22.5,0.688,5.6,85,5.2,444,2,1
Dalvin Cook,619.2,23,11,10,133,615,2,22,70,4.6,55.9,12.1,49,40,305,7.6,2,15,27,3.6,27.7,0.816,6.2,173,5.3,920,4,2
Dalvin Cook,711.4,24,14,14,250,1135,13,60,75,4.5,81.1,17.9,63,53,519,9.8,0,26,31,3.8,37.1,0.841,8.2,303,5.5,1654,13,4
Dalvin Cook,478.9,25,14,14,312,1557,16,91,70,5,111.2,22.3,54,44,361,8.2,1,17,50,3.1,25.8,0.815,6.7,356,5.4,1918,17,5
Dalvin Cook,531.4,26,13,13,249,1159,6,57,66,4.7,89.2,19.2,49,34,224,6.6,0,9,24,2.6,17.2,0.694,4.6,283,4.9,1383,6,3
Stefon Diggs,375.9,22,13,9,3,13,0,1,10,4.3,1,0.2,84,52,720,13.8,4,30,40,4,55.4,0.619,8.6,55,13.3,733,4,2
Stefon Diggs,370.6,23,13,11,3,10,0,1,12,3.3,0.8,0.2,112,84,903,10.8,3,48,46,6.5,69.5,0.75,8.1,87,10.5,913,3,0
Stefon Diggs,480.9,24,14,14,8,13,0,1,9,1.6,0.9,0.6,95,64,849,13.3,8,42,59,4.6,60.6,0.674,8.9,72,12,862,8,0
Stefon Diggs,448.3,25,15,14,10,62,0,3,20,6.2,4.1,0.7,149,102,1021,10,9,49,75,6.8,68.1,0.685,6.9,112,9.7,1083,9,0
Stefon Diggs,635.8,26,15,15,5,61,0,3,27,12.2,4.1,0.3,94,63,1130,17.9,6,41,66,4.2,75.3,0.67,12,68,17.5,1191,6,4
Stefon Diggs,528.5,27,16,15,1,1,0,0,1,1,0.1,0.1,166,127,1535,12.1,8,73,55,7.9,95.9,0.765,9.2,128,12,1536,8,0
Stefon Diggs,599.8,28,17,17,0,0,0,0,0,0,0,0,164,103,1225,11.9,10,66,61,6.1,72.1,0.628,7.5,103,11.9,1225,10,1
CeeDee Lamb,468.4,21,16,14,10,82,1,4,19,8.2,5.1,0.6,111,74,935,12.6,5,46,52,4.6,58.4,0.667,8.4,84,12.1,1017,6,2
CeeDee Lamb,582.8,22,16,13,9,76,0,4,33,8.4,4.8,0.6,120,79,1102,13.9,6,54,49,4.9,68.9,0.658,9.2,88,13.4,1178,6,0
Alvin Kamara,664.6,22,16,3,120,728,8,42,74,6.1,45.5,7.5,100,81,826,10.2,5,38,40,5.1,51.6,0.81,8.3,201,7.7,1554,13,1
Alvin Kamara,508,23,15,13,194,883,14,57,49,4.6,58.9,12.9,105,81,709,8.8,4,31,42,5.4,47.3,0.771,6.8,275,5.8,1592,18,1
Alvin Kamara,713.4,24,14,9,171,797,5,32,40,4.7,56.9,12.2,97,81,533,6.6,1,28,41,5.8,38.1,0.835,5.5,252,5.3,1330,6,4
Alvin Kamara,502.1,25,15,10,187,932,16,58,49,5,62.1,12.5,107,83,756,9.1,5,35,52,5.5,50.4,0.776,7.1,270,6.3,1688,21,1
Alvin Kamara,489.1,26,13,10,240,898,4,42,30,3.7,69.1,18.5,67,47,439,9.3,5,20,31,3.6,33.8,0.701,6.6,287,4.7,1337,9,0
Tony Pollard,246.4,22,15,0,86,455,2,21,44,5.3,30.3,5.7,20,15,107,7.1,1,4,21,1,7.1,0.75,5.4,101,5.6,562,3,1
Tony Pollard,363.8,23,16,2,101,435,4,23,42,4.3,27.2,6.3,40,28,193,6.9,1,9,30,1.8,12.1,0.7,4.8,129,4.9,628,5,0
Tony Pollard,524.4,24,15,0,130,719,2,35,58,5.5,47.9,8.7,46,39,337,8.6,0,15,32,2.6,22.5,0.848,7.3,169,6.2,1056,2,2
Miles Sanders,375.2,22,16,11,179,818,3,30,65,4.6,51.1,11.2,63,50,509,10.2,3,19,45,3.1,31.8,0.794,8.1,229,5.8,1327,6,2
Miles Sanders,297.6,23,12,11,164,867,6,39,82,5.3,72.3,13.7,52,28,197,7,0,8,28,2.3,16.4,0.538,3.8,192,5.5,1064,6,4
Miles Sanders,486.1,24,12,12,137,754,0,33,38,5.5,62.8,11.4,34,26,158,6.1,0,6,25,2.2,13.2,0.765,4.6,163,5.6,912,0,1
Travis Kelce,347.6,24,1,0,0,0,0,0,0,0,0,0,0,0,0,0,0,0,0,0,0,0,0,0,0,0,0,0
Travis Kelce,360.5,25,16,11,0,0,0,0,0,0,0,0,87,67,862,12.9,5,46,34,4.2,53.9,0.77,9.9,67,12.9,862,5,4
Travis Kelce,445,26,16,16,0,0,0,0,0,0,0,0,103,72,875,12.2,5,40,42,4.5,54.7,0.699,8.5,72,12.2,875,5,2
Travis Kelce,444.5,27,16,15,1,-5,0,0,-5,-5,-0.3,0.1,117,85,1125,13.2,4,55,80,5.3,70.3,0.726,9.6,86,13,1120,4,0
Travis Kelce,559.8,28,15,15,2,7,0,2,4,3.5,0.5,0.1,122,83,1038,12.5,8,53,44,5.5,69.2,0.68,8.5,85,12.3,1045,8,0
Travis Kelce,500.9,29,16,16,0,0,0,0,0,0,0,0,150,103,1336,13,10,68,43,6.4,83.5,0.687,8.9,103,13,1336,10,2
Travis Kelce,593.8,30,16,16,1,4,1,1,4,4,0.3,0.1,136,97,1229,12.7,5,65,47,6.1,76.8,0.713,9,98,12.6,1233,6,1
Travis Kelce,488.4,31,15,15,0,0,0,0,0,0,0,0,145,105,1416,13.5,11,79,45,7,94.4,0.724,9.8,105,13.5,1416,11,1
Travis Kelce,582.9,32,16,16,2,3,1,1,4,1.5,0.2,0.1,134,92,1125,12.2,9,63,69,5.8,70.3,0.687,8.4,94,12,1128,10,1
Joe Mixon,536.2,21,14,7,178,626,4,39,25,3.5,44.7,12.7,34,30,287,9.6,0,10,67,2.1,20.5,0.882,8.4,208,4.4,913,4,3
Joe Mixon,510.2,22,14,13,237,1168,8,60,51,4.9,83.4,16.9,55,43,296,6.9,1,14,21,3.1,21.1,0.782,5.4,280,5.2,1464,9,0
Joe Mixon,212.8,23,16,15,278,1137,5,56,41,4.1,71.1,17.4,45,35,287,8.2,3,14,33,2.2,17.9,0.778,6.4,313,4.5,1424,8,0
Joe Mixon,589.7,24,6,6,119,428,3,20,34,3.6,71.3,19.8,26,21,138,6.6,1,5,19,3.5,23,0.808,5.3,140,4,566,4,1
Joe Mixon,490.5,25,16,16,292,1205,13,60,32,4.1,75.3,18.3,48,42,314,7.5,3,11,52,2.6,19.6,0.875,6.5,334,4.5,1519,16,2
Terry McLaurin,453.4,24,14,14,0,0,0,0,0,0,0,0,93,58,919,15.8,7,43,75,4.1,65.6,0.624,9.9,58,15.8,919,7,0
Terry McLaurin,426.5,25,15,15,2,30,0,2,27,15,2,0.1,134,87,1118,12.9,4,51,68,5.8,74.5,0.649,8.3,89,12.9,1148,4,1
Terry McLaurin,471,26,17,17,1,12,0,1,12,12,0.7,0.1,130,77,1053,13.7,5,47,46,4.5,61.9,0.592,8.1,78,13.7,1065,5,0
Leonard Fournette,245.2,22,13,13,268,1040,9,51,90,3.9,80,20.6,48,36,302,8.4,1,18,28,2.8,23.2,0.75,6.3,304,4.4,1342,10,2
Leonard Fournette,594.2,23,8,8,133,439,5,23,25,3.3,54.9,16.6,26,22,185,8.4,1,10,31,2.8,23.1,0.846,7.1,155,4,624,6,0
Leonard Fournette,252,24,15,15,265,1152,3,55,81,4.3,76.8,17.7,100,76,522,6.9,0,23,27,5.1,34.8,0.76,5.2,341,4.9,1674,3,1
Leonard Fournette,506.8,25,13,3,97,367,6,21,46,3.8,28.2,7.5,47,36,233,6.5,0,9,20,2.8,17.9,0.766,5,133,4.5,600,6,0
Leonard Fournette,466.3,26,14,13,180,812,8,45,47,4.5,58,12.9,84,69,454,6.6,2,30,23,4.9,32.4,0.821,5.4,249,5.1,1266,10,1
Amari Cooper,454.9,21,16,15,3,-3,0,0,2,-1,-0.2,0.2,130,72,1070,14.9,6,47,68,4.5,66.9,0.554,8.2,75,14.2,1067,6,1
Amari Cooper,293.2,22,16,14,1,0,0,0,0,0,0,0.1,132,83,1153,13.9,5,49,64,5.2,72.1,0.629,8.7,84,13.7,1153,5,2
Amari Cooper,420.5,23,14,12,1,4,0,1,4,4,0.3,0.1,96,48,680,14.2,7,28,87,3.4,48.6,0.5,7.1,49,14,684,7,1
Amari Cooper,305.8,24,15,15,2,20,0,1,11,10,1.3,0.1,107,75,1005,13.4,7,53,90,5,67,0.701,9.4,77,13.3,1025,7,2
Amari Cooper,114.7,0,9,9,1,11,0,1,11,11,1.2,0.1,76,53,725,13.7,6,39,90,5.9,80.6,0.697,9.5,54,13.6,736,6,2
Amari Cooper,485.5,0,6,6,1,9,0,0,9,9,1.5,0.2,31,22,280,12.7,1,14,36,3.7,46.7,0.71,9,23,12.6,289,1,0
Amari Cooper,460.4,25,16,16,1,6,0,0,6,6,0.4,0.1,119,79,1189,15.1,8,54,53,4.9,74.3,0.664,10,80,14.9,1195,8,0
Amari Cooper,373.5,26,16,15,6,14,0,1,10,2.3,0.9,0.4,130,92,1114,12.1,5,54,69,5.8,69.6,0.708,8.6,98,11.5,1128,5,0
Amari Cooper,480,27,15,14,0,0,0,0,0,0,0,0,104,68,865,12.7,8,45,41,4.5,57.7,0.654,8.3,68,12.7,865,8,1
Jamaal Williams,247.2,22,16,7,153,556,4,32,25,3.6,34.8,9.6,34,25,262,10.5,2,12,54,1.6,16.4,0.735,7.7,178,4.6,818,6,0
Jamaal Williams,288.9,23,16,8,121,464,3,25,20,3.8,29,7.6,41,27,210,7.8,0,11,26,1.7,13.1,0.659,5.1,148,4.6,674,3,0
Jamaal Williams,271.3,24,14,2,107,460,1,23,45,4.3,32.9,7.6,45,39,253,6.5,5,16,17,2.8,18.1,0.867,5.6,146,4.9,713,6,0
Jamaal Williams,269.4,25,14,3,119,505,2,29,25,4.2,36.1,8.5,35,31,236,7.6,1,11,29,2.2,16.9,0.886,6.7,150,4.9,741,3,0
Jamaal Williams,449.7,26,13,11,153,601,3,42,20,3.9,46.2,11.8,28,26,157,6,0,6,15,2,12.1,0.929,5.6,179,4.2,758,3,1
Mike Evans,451.8,21,15,15,0,0,0,0,0,0,0,0,122,68,1051,15.5,12,46,56,4.5,70.1,0.557,8.6,68,15.5,1051,12,0
Mike Evans,564.3,22,15,14,0,0,0,0,0,0,0,0,148,74,1206,16.3,3,63,68,4.9,80.4,0.5,8.1,74,16.3,1206,3,1
Mike Evans,399.3,23,16,16,0,0,0,0,0,0,0,0,173,96,1321,13.8,12,82,45,6,82.6,0.555,7.6,96,13.8,1321,12,0
Mike Evans,587.2,24,15,15,0,0,0,0,0,0,0,0,136,71,1001,14.1,5,55,42,4.7,66.7,0.522,7.4,71,14.1,1001,5,1
Mike Evans,462.1,25,16,16,0,0,0,0,0,0,0,0,138,86,1524,17.7,8,68,72,5.4,95.3,0.623,11,86,17.7,1524,8,2
Mike Evans,449.8,26,13,13,0,0,0,0,0,0,0,0,118,67,1157,17.3,8,54,67,5.2,89,0.568,9.8,67,17.3,1157,8,0
Mike Evans,471.5,27,16,16,0,0,0,0,0,0,0,0,109,70,1006,14.4,13,55,50,4.4,62.9,0.642,9.2,70,14.4,1006,13,0
Mike Evans,450.2,28,16,16,1,10,0,1,10,10,0.6,0.1,114,74,1035,14,14,56,46,4.6,64.7,0.649,9.1,75,13.9,1045,14,0
Christian Kirk,326.6,22,12,7,3,35,0,2,23,11.7,2.9,0.3,68,43,590,13.7,3,21,75,3.6,49.2,0.632,8.7,46,13.6,625,3,0
Christian Kirk,269.2,23,13,13,10,93,0,4,28,9.3,7.2,0.8,108,68,709,10.4,3,31,69,5.2,54.5,0.63,6.6,78,10.3,802,3,0
Christian Kirk,404.9,24,14,10,2,3,0,1,3,1.5,0.2,0.1,79,48,621,12.9,6,30,80,3.4,44.4,0.608,7.9,50,12.5,624,6,1
Christian Kirk,465.7,25,17,11,1,11,0,1,11,11,0.6,0.1,103,77,982,12.8,5,44,50,4.5,57.8,0.748,9.5,78,12.7,993,5,0
David Montgomery,564.4,22,16,8,242,889,6,50,55,3.7,55.6,15.1,35,25,185,7.4,1,7,30,1.6,11.6,0.714,5.3,267,4,1074,7,2
David Montgomery,427,23,15,14,247,1070,8,59,80,4.3,71.3,16.5,68,54,438,8.1,2,25,28,3.6,29.2,0.794,6.4,301,5,1508,10,1
David Montgomery,401.1,24,13,13,225,849,7,55,41,3.8,65.3,17.3,51,42,301,7.2,0,18,16,3.2,23.2,0.824,5.9,267,4.3,1150,7,1
Devin Singletary,334.8,22,12,8,151,775,2,37,38,5.1,64.6,12.6,41,29,194,6.7,2,5,49,2.4,16.2,0.707,4.7,180,5.4,969,4,4
Devin Singletary,407.4,23,16,16,156,687,2,40,51,4.4,42.9,9.8,50,38,269,7.1,0,8,34,2.4,16.8,0.76,5.4,194,4.9,956,2,1
Devin Singletary,397.7,24,17,16,188,870,7,44,46,4.6,51.2,11.1,50,40,228,5.7,1,11,19,2.4,13.4,0.8,4.6,228,4.8,1098,8,5
Raheem Mostert,0,23,11,0,0,0,0,0,0,0,0,0,0,0,0,0,0,0,0,0,0,0,0,0,0,0,0,1
Raheem Mostert,0,0,3,0,0,0,0,0,0,0,0,0,0,0,0,0,0,0,0,0,0,0,0,0,0,0,0,1
Raheem Mostert,0,0,1,0,0,0,0,0,0,0,0,0,0,0,0,0,0,0,0,0,0,0,0,0,0,0,0,0
Raheem Mostert,0,0,7,0,0,0,0,0,0,0,0,0,0,0,0,0,0,0,0,0,0,0,0,0,0,0,0,0
Raheem Mostert,0,24,3,0,1,6,0,0,6,6,2,0.3,0,0,0,0,0,0,0,0,0,0,0,1,6,6,0,0
Raheem Mostert,0,0,2,0,0,0,0,0,0,0,0,0,0,0,0,0,0,0,0,0,0,0,0,0,0,0,0,0
Raheem Mostert,0,0,1,0,1,6,0,0,6,6,6,1,0,0,0,0,0,0,0,0,0,0,0,1,6,6,0,0
Raheem Mostert,95.8,25,11,0,6,30,0,1,16,5,2.7,0.5,0,0,0,0,0,0,0,0,0,0,0,6,5,30,0,1
Raheem Mostert,355.6,26,9,0,34,261,1,13,52,7.7,29,3.8,7,6,25,4.2,0,1,23,0.7,2.8,0.857,3.6,40,7.2,286,1,1
Raheem Mostert,235.1,27,16,0,137,772,8,31,41,5.6,48.3,8.6,22,14,180,12.9,2,6,39,0.9,11.3,0.636,8.2,151,6.3,952,10,2
Raheem Mostert,0,28,8,8,104,521,2,22,80,5,65.1,13,19,16,156,9.8,1,5,76,2,19.5,0.842,8.2,120,5.6,677,3,1
Raheem Mostert,386.9,29,1,1,2,20,0,1,11,10,20,2,0,0,0,0,0,0,0,0,0,0,0,2,10,20,0,0
James Conner,566,22,14,0,32,144,0,4,23,4.5,10.3,2.3,1,0,0,0,0,0,0,0,0,0,0,32,4.5,144,0,0
James Conner,288.5,23,13,12,215,973,12,56,30,4.5,74.8,16.5,71,55,497,9,1,20,29,4.2,38.2,0.775,7,270,5.4,1470,13,4
James Conner,347.8,24,10,10,116,464,4,26,25,4,46.4,11.6,38,34,251,7.4,3,14,26,3.4,25.1,0.895,6.6,150,4.8,715,7,1
James Conner,479.1,25,13,11,169,721,6,42,59,4.3,55.5,13,43,35,215,6.1,0,10,18,2.7,16.5,0.814,5,204,4.6,936,6,2
James Conner,412.6,26,15,6,202,752,15,53,35,3.7,50.1,13.5,39,37,375,10.1,3,18,45,2.5,25,0.949,9.6,239,4.7,1127,18,2
D.K. Metcalf,531.9,22,16,15,2,11,0,0,7,5.5,0.7,0.1,100,58,900,15.5,7,39,54,3.6,56.3,0.58,9,60,15.2,911,7,3
D.K. Metcalf,436.9,23,16,16,0,0,0,0,0,0,0,0,129,83,1303,15.7,10,63,62,5.2,81.4,0.643,10.1,83,15.7,1303,10,1
D.K. Metcalf,436.4,24,17,17,1,6,0,0,6,6,0.4,0.1,129,75,967,12.9,12,48,84,4.4,56.9,0.581,7.5,76,12.8,973,12,1
Jeff Wilson,74.7,23,6,2,66,266,0,13,18,4,44.3,11,15,12,98,8.2,0,5,24,2,16.3,0.8,6.5,78,4.7,364,0,3
Jeff Wilson,288.9,24,10,0,27,105,4,9,25,3.9,10.5,2.7,5,3,34,11.3,1,1,25,0.3,3.4,0.6,6.8,30,4.6,139,5,0
Jeff Wilson,114.5,25,12,3,126,600,7,31,34,4.8,50,10.5,28,13,133,10.2,3,8,21,1.1,11.1,0.464,4.8,139,5.3,733,10,2
Jeff Wilson,365.5,26,9,4,79,294,2,19,17,3.7,32.7,8.8,8,7,31,4.4,0,1,11,0.8,3.4,0.875,3.9,86,3.8,325,2,1
Brandon Aiyuk,334.9,22,12,11,6,77,2,3,38,12.8,6.4,0.5,96,60,748,12.5,5,42,49,5,62.3,0.625,7.8,66,12.5,825,7,0
Brandon Aiyuk,435.4,23,17,16,5,17,0,0,8,3.4,1,0.3,84,56,826,14.8,5,37,43,3.3,48.6,0.667,9.8,61,13.8,843,5,2
Tyler Lockett,266.3,23,16,8,5,20,0,1,8,4,1.3,0.3,69,51,664,13,6,31,49,3.2,41.5,0.739,9.6,56,12.2,684,6,2
Tyler Lockett,240.9,24,15,9,6,114,1,4,75,19,7.6,0.4,66,41,597,14.6,1,23,57,2.7,39.8,0.621,9,47,15.1,711,2,0
Tyler Lockett,423.2,25,16,8,10,58,0,5,22,5.8,3.6,0.6,71,45,555,12.3,2,24,74,2.8,34.7,0.634,7.8,55,11.1,613,2,0
Tyler Lockett,443.6,26,16,14,13,69,0,3,18,5.3,4.3,0.8,70,57,965,16.9,10,37,52,3.6,60.3,0.814,13.8,70,14.8,1034,10,2
Tyler Lockett,474.2,27,16,16,4,-5,0,0,3,-1.3,-0.3,0.3,110,82,1057,12.9,8,53,44,5.1,66.1,0.745,9.6,86,12.2,1052,8,1
Tyler Lockett,476.2,28,16,16,0,0,0,0,0,0,0,0,132,100,1054,10.5,10,57,47,6.3,65.9,0.758,8,100,10.5,1054,10,1
Tyler Lockett,443.9,29,16,16,2,9,0,0,7,4.5,0.6,0.1,107,73,1175,16.1,8,41,69,4.6,73.4,0.682,11,75,15.8,1184,8,0
Tee Higgins,435.3,21,16,14,5,28,0,1,13,5.6,1.8,0.3,108,67,908,13.6,6,52,67,4.2,56.8,0.62,8.4,72,13,936,6,1
Tee Higgins,424.7,22,14,14,0,0,0,0,0,0,0,0,110,74,1091,14.7,6,53,54,5.3,77.9,0.673,9.9,74,14.7,1091,6,1
Chris Godwin,345.6,21,16,2,0,0,0,0,0,0,0,0,55,34,525,15.4,1,27,70,2.1,32.8,0.618,9.5,34,15.4,525,1,0
Chris Godwin,542.3,22,16,5,0,0,0,0,0,0,0,0,95,59,842,14.3,7,48,48,3.7,52.6,0.621,8.9,59,14.3,842,7,4
Chris Godwin,357,23,14,14,1,8,0,0,8,8,0.6,0.1,121,86,1333,15.5,9,63,71,6.1,95.2,0.711,11,87,15.4,1341,9,0
Chris Godwin,467.2,24,12,12,0,0,0,0,0,0,0,0,84,65,840,12.9,7,43,47,5.4,70,0.774,10,65,12.9,840,7,1
Chris Godwin,426.4,25,14,14,4,21,1,4,9,5.3,1.5,0.3,127,98,1103,11.3,5,55,44,7,78.8,0.772,8.7,102,11,1124,6,2
Jerry Jeudy,177,21,16,14,0,0,0,0,0,0,0,0,113,52,856,16.5,3,39,92,3.3,53.5,0.46,7.6,52,16.5,856,3,2
Jerry Jeudy,406.6,22,10,5,2,3,0,0,3,1.5,0.3,0.2,56,38,467,12.3,0,22,40,3.8,46.7,0.679,8.3,40,11.8,470,0,1
Jonathan Taylor,803.3,21,15,13,232,1169,11,69,62,5,77.9,15.5,39,36,299,8.3,1,12,39,2.4,19.9,0.923,7.7,268,5.5,1468,12,1
Jonathan Taylor,347.2,22,17,17,332,1811,18,107,83,5.5,106.5,19.5,51,40,360,9,2,12,76,2.4,21.2,0.784,7.1,372,5.8,2171,20,4
AJ Dillon,406.8,22,11,0,46,242,2,11,30,5.3,22,4.2,2,2,21,10.5,0,1,16,0.2,1.9,1,10.5,48,5.5,263,2,0
AJ Dillon,360.8,23,17,2,187,803,5,50,36,4.3,47.2,11,37,34,313,9.2,2,15,50,2,18.4,0.919,8.5,221,5,1116,7,2
Ezekiel Elliott,453.6,21,15,15,322,1631,15,95,60,5.1,108.7,21.5,39,32,363,11.3,1,11,83,2.1,24.2,0.821,9.3,354,5.6,1994,16,5
Ezekiel Elliott,719.3,22,10,10,242,983,7,57,30,4.1,98.3,24.2,38,26,269,10.3,2,6,72,2.6,26.9,0.684,7.1,268,4.7,1252,9,1
Ezekiel Elliott,665.1,23,15,15,304,1434,6,74,41,4.7,95.6,20.3,95,77,567,7.4,3,22,38,5.1,37.8,0.811,6,381,5.3,2001,9,6
Ezekiel Elliott,483.1,24,16,16,301,1357,12,78,33,4.5,84.8,18.8,71,54,420,7.8,2,21,27,3.4,26.3,0.761,5.9,355,5,1777,14,3
Ezekiel Elliott,503.7,25,15,15,244,979,6,62,31,4,65.3,16.3,71,52,338,6.5,2,20,19,3.5,22.5,0.732,4.8,296,4.4,1317,8,6
Ezekiel Elliott,379.4,26,17,17,237,1002,10,55,47,4.2,58.9,13.9,65,47,287,6.1,2,17,21,2.8,16.9,0.723,4.4,284,4.5,1289,12,1
Michael Pittman Jr.,459.8,23,13,8,3,26,0,1,21,8.7,2,0.2,61,40,503,12.6,1,22,45,3.1,38.7,0.656,8.2,43,12.3,529,1,0
Michael Pittman Jr.,405.5,24,17,17,5,44,0,1,25,8.8,2.6,0.3,129,88,1082,12.3,6,54,57,5.2,63.6,0.682,8.4,93,12.1,1126,6,1
D.J. Moore,471.5,21,16,10,13,172,0,6,32,13.2,10.8,0.8,82,55,788,14.3,2,33,82,3.4,49.3,0.671,9.6,68,14.1,960,2,4
D.J. Moore,454.5,22,15,15,6,40,0,3,13,6.7,2.7,0.4,135,87,1175,13.5,4,63,52,5.8,78.3,0.644,8.7,93,13.1,1215,4,2
D.J. Moore,476.5,23,15,14,2,22,0,1,21,11,1.5,0.1,118,66,1193,18.1,4,53,74,4.4,79.5,0.559,10.1,68,17.9,1215,4,0
D.J. Moore,387.3,24,17,17,8,48,0,4,14,6,2.8,0.5,163,93,1157,12.4,4,60,64,5.5,68.1,0.571,7.1,101,11.9,1205,4,1
D'Onta Foreman,14.1,21,10,1,78,327,2,13,39,4.2,32.7,7.8,8,6,83,13.8,0,4,34,0.6,8.3,0.75,10.4,84,4.9,410,2,2
D'Onta Foreman,37,22,1,0,7,-1,0,0,2,-0.1,-1,7,2,2,28,14,1,1,20,2,28,1,14,9,3,27,1,1
D'Onta Foreman,229.7,24,6,0,22,95,0,6,15,4.3,15.8,3.7,1,1,5,5,1,1,5,0.2,0.8,1,5,23,4.3,100,1,0
D'Onta Foreman,315,25,9,3,133,566,3,22,35,4.3,62.9,14.8,11,9,123,13.7,0,6,39,1,13.7,0.818,11.2,142,4.9,689,3,2
JuJu Smith-Schuster,582.7,21,14,7,0,0,0,0,0,0,0,0,79,58,917,15.8,7,37,97,4.1,65.5,0.734,11.6,58,15.8,917,7,0
JuJu Smith-Schuster,223.6,22,16,13,1,13,0,1,13,13,0.8,0.1,166,111,1426,12.8,7,67,97,6.9,89.1,0.669,8.6,112,12.8,1439,7,1
JuJu Smith-Schuster,394.3,23,12,12,0,0,0,0,0,0,0,0,70,42,552,13.1,3,23,76,3.5,46,0.6,7.9,42,13.1,552,3,1
JuJu Smith-Schuster,62.4,24,16,14,0,0,0,0,0,0,0,0,128,97,831,8.6,9,48,31,6.1,51.9,0.758,6.5,97,8.6,831,9,3
JuJu Smith-Schuster,369.9,25,5,5,3,9,1,1,3,3,1.8,0.6,28,15,129,8.6,0,6,24,3,25.8,0.536,4.6,18,7.7,138,1,0
D'Andre Swift,420.7,21,13,4,114,521,8,31,54,4.6,40.1,8.8,57,46,357,7.8,2,15,26,3.5,27.5,0.807,6.3,160,5.5,878,10,3
D'Andre Swift,373.3,22,13,4,151,617,5,28,57,4.1,47.5,11.6,78,62,452,7.3,2,18,63,4.8,34.8,0.795,5.8,213,5,1069,7,2
T.J. Hockenson,317.9,22,12,7,0,0,0,0,0,0,0,0,59,32,367,11.5,2,19,39,2.7,30.6,0.542,6.2,32,11.5,367,2,0
T.J. Hockenson,259.9,23,16,16,1,0,0,0,0,0,0,0.1,101,67,723,10.8,6,40,51,4.2,45.2,0.663,7.2,68,10.6,723,6,1
T.J. Hockenson,394.2,24,12,12,0,0,0,0,0,0,0,0,84,61,583,9.6,4,32,33,5.1,48.6,0.726,6.9,61,9.6,583,4,0
Diontae Johnson,407.4,23,16,12,4,41,0,2,17,10.3,2.6,0.3,92,59,680,11.5,5,31,45,3.7,42.5,0.641,7.4,63,11.4,721,5,5
Diontae Johnson,515.2,24,15,13,3,15,0,0,9,5,1,0.2,144,88,923,10.5,7,45,47,5.9,61.5,0.611,6.4,91,10.3,938,7,2
Diontae Johnson,356.1,25,16,14,5,53,0,2,25,10.6,3.3,0.3,169,107,1161,10.9,8,59,50,6.7,72.6,0.633,6.9,112,10.8,1214,8,2
Cam Akers,6.9,21,13,5,145,625,2,26,61,4.3,48.1,11.2,14,11,123,11.2,1,4,38,0.8,9.5,0.786,8.8,156,4.8,748,3,1
Cam Akers,321.9,22,1,0,5,3,0,0,2,0.6,3,5,3,3,10,3.3,0,0,6,3,10,1,3.3,8,1.6,13,0,0
Antonio Gibson,489.3,22,14,10,170,795,11,40,40,4.7,56.8,12.1,44,36,247,6.9,0,8,40,2.6,17.6,0.818,5.6,206,5.1,1042,11,1
Antonio Gibson,343.7,23,16,14,258,1037,7,65,27,4,64.8,16.1,52,42,294,7,3,12,73,2.6,18.4,0.808,5.7,300,4.4,1331,10,6
Mike Williams,316.6,23,10,1,0,0,0,0,0,0,0,0,23,11,95,8.6,0,7,20,1.1,9.5,0.478,4.1,11,8.6,95,0,0
Mike Williams,361.9,24,16,5,7,28,1,2,19,4,1.8,0.4,66,43,664,15.4,10,36,55,2.7,41.5,0.652,10.1,50,13.8,692,11,0
Mike Williams,305.1,25,15,15,1,2,0,0,2,2,0.1,0.1,90,49,1001,20.4,2,41,56,3.3,66.7,0.544,11.1,50,20.1,1003,2,0
Mike Williams,473.8,26,15,11,1,1,0,0,1,1,0.1,0.1,85,48,756,15.8,5,35,64,3.2,50.4,0.565,8.9,49,15.4,757,5,0
Mike Williams,355.5,27,16,14,0,0,0,0,0,0,0,0,129,76,1146,15.1,9,51,72,4.8,71.6,0.589,8.9,76,15.1,1146,9,0
Latavius Murray,458.4,24,15,3,82,424,2,18,90,5.2,28.3,5.5,23,17,143,8.4,0,3,46,1.1,9.5,0.739,6.2,99,5.7,567,2,1
Latavius Murray,416.6,25,16,16,266,1066,6,49,54,4,66.6,16.6,53,41,232,5.7,0,9,23,2.6,14.5,0.774,4.4,307,4.2,1298,6,4
Latavius Murray,344.5,26,14,12,195,788,12,52,42,4,56.3,13.9,43,33,264,8,0,11,39,2.4,18.9,0.767,6.1,228,4.6,1052,12,2
Latavius Murray,273.7,27,16,11,216,842,8,43,46,3.9,52.6,13.5,17,15,103,6.9,0,4,28,0.9,6.4,0.882,6.1,231,4.1,945,8,1
Latavius Murray,331.6,28,16,6,140,578,6,23,38,4.1,36.1,8.8,26,22,141,6.4,0,7,16,1.4,8.8,0.846,5.4,162,4.4,719,6,0
Latavius Murray,300.6,29,16,8,146,637,5,38,30,4.4,39.8,9.1,43,34,235,6.9,1,9,30,2.1,14.7,0.791,5.5,180,4.8,872,6,0
Latavius Murray,218.8,30,15,7,146,656,4,36,36,4.5,43.7,9.7,26,23,176,7.7,1,8,25,1.5,11.7,0.885,6.8,169,4.9,832,5,1
Latavius Murray,328.6,31,14,6,119,501,6,36,46,4.2,35.8,8.5,13,10,75,7.5,0,2,18,0.7,5.4,0.769,5.8,129,4.5,576,6,0
Cooper Kupp,253.3,24,15,6,0,0,0,0,0,0,0,0,94,62,869,14,5,42,64,4.1,57.9,0.66,9.2,62,14,869,5,1
Cooper Kupp,497.5,25,8,8,4,25,0,3,12,6.3,3.1,0.5,55,40,566,14.2,6,25,70,5,70.8,0.727,10.3,44,13.4,591,6,0
Cooper Kupp,410.1,26,16,14,2,4,0,0,6,2,0.3,0.1,134,94,1161,12.4,10,51,66,5.9,72.6,0.701,8.7,96,12.1,1165,10,3
Cooper Kupp,830.5,27,15,12,4,33,0,3,16,8.3,2.2,0.3,124,92,974,10.6,3,45,55,6.1,64.9,0.742,7.9,96,10.5,1007,3,1
Cooper Kupp,372.2,28,17,17,4,18,0,1,18,4.5,1.1,0.2,191,145,1947,13.4,16,89,59,8.5,114.5,0.759,10.2,149,13.2,1965,16,0
Deebo Samuel,164.1,23,15,11,14,159,3,5,31,11.4,10.6,0.9,81,57,802,14.1,3,32,42,3.8,53.5,0.704,9.9,71,13.5,961,6,2
Deebo Samuel,684,24,7,5,8,26,0,1,10,3.3,3.7,1.1,44,33,391,11.8,1,19,35,4.7,55.9,0.75,8.9,41,10.2,417,1,0
Deebo Samuel,339.2,25,16,15,59,365,8,21,49,6.2,22.8,3.7,121,77,1405,18.2,6,51,83,4.8,87.8,0.636,11.6,136,13,1770,14,4
Mark Andrews,375.6,23,16,3,0,0,0,0,0,0,0,0,50,34,552,16.2,3,28,74,2.1,34.5,0.68,11,34,16.2,552,3,0
Mark Andrews,306.3,24,15,4,0,0,0,0,0,0,0,0,98,64,852,13.3,10,44,51,4.3,56.8,0.653,8.7,64,13.3,852,10,2
Mark Andrews,567.3,25,14,2,0,0,0,0,0,0,0,0,88,58,701,12.1,7,37,39,4.1,50.1,0.659,8,58,12.1,701,7,2
Mark Andrews,357.5,26,17,9,1,0,0,0,0,0,0,0.1,153,107,1361,12.7,9,75,43,6.3,80.1,0.699,8.9,108,12.6,1361,9,1
Curtis Samuel,252.4,21,9,4,4,64,0,3,31,16,7.1,0.4,26,15,115,7.7,0,6,23,1.7,12.8,0.577,4.4,19,9.4,179,0,0
Curtis Samuel,323.1,22,13,8,8,84,2,3,33,10.5,6.5,0.6,65,39,494,12.7,5,24,53,3,38,0.6,7.6,47,12.3,578,7,1
Curtis Samuel,420.3,23,16,15,19,130,1,7,16,6.8,8.1,1.2,105,54,627,11.6,6,36,44,3.4,39.2,0.514,6,73,10.4,757,7,0
Curtis Samuel,17.4,24,15,5,41,200,2,10,45,4.9,13.3,2.7,97,77,851,11.1,3,39,44,5.1,56.7,0.794,8.8,118,8.9,1051,5,1
Curtis Samuel,344.9,25,5,1,4,11,0,0,8,2.8,2.2,0.8,9,6,27,4.5,0,4,10,1.2,5.4,0.667,3,10,3.8,38,0,0
Zay Jones,291.6,22,15,10,0,0,0,0,0,0,0,0,74,27,316,11.7,2,19,33,1.8,21.1,0.365,4.3,27,11.7,316,2,0
Zay Jones,92.7,23,16,15,1,0,0,0,0,0,0,0.1,102,56,652,11.6,7,33,57,3.5,40.8,0.549,6.4,57,11.4,652,7,1
Zay Jones,27.7,24,15,9,1,3,0,0,3,3,0.2,0.1,45,27,216,8,0,10,23,1.8,14.4,0.6,4.8,28,7.8,219,0,0
Zay Jones,65,0,5,2,0,0,0,0,0,0,0,0,18,7,69,9.9,0,4,23,1.4,13.8,0.389,3.8,7,9.9,69,0,0
Zay Jones,66.2,0,10,7,1,3,0,0,3,3,0.3,0.1,27,20,147,7.4,0,6,16,2,14.7,0.741,5.4,21,7.1,150,0,0
Zay Jones,215.7,25,16,2,0,0,0,0,0,0,0,0,20,14,154,11,1,6,37,0.9,9.6,0.7,7.7,14,11,154,1,0
Zay Jones,364.3,26,17,9,2,3,0,0,4,1.5,0.2,0.1,70,47,546,11.6,1,29,43,2.8,32.1,0.671,7.8,49,11.2,549,1,1
Donovan Peoples-Jones,227.1,21,12,2,0,0,0,0,0,0,0,0,20,14,304,21.7,2,10,75,1.2,25.3,0.7,15.2,14,21.7,304,2,0
Donovan Peoples-Jones,329.3,22,14,9,0,0,0,0,0,0,0,0,58,34,597,17.6,3,26,60,2.4,42.6,0.586,10.3,34,17.6,597,3,2
Gabriel Davis,235.7,21,16,11,1,0,0,0,0,0,0,0.1,62,35,599,17.1,7,27,56,2.2,37.4,0.565,9.7,36,16.6,599,7,1
Gabriel Davis,338.8,22,16,4,0,0,0,0,0,0,0,0,63,35,549,15.7,6,29,49,2.2,34.3,0.556,8.7,35,15.7,549,6,0
Courtland Sutton,442.7,23,16,9,1,-1,0,0,-1,-1,-0.1,0.1,84,42,704,16.8,4,30,42,2.6,44,0.5,8.4,43,16.3,703,4,0
Courtland Sutton,22.8,24,16,14,3,17,0,1,9,5.7,1.1,0.2,124,72,1112,15.4,6,50,70,4.5,69.5,0.581,9,75,15.1,1129,6,2
Courtland Sutton,302.8,25,1,1,0,0,0,0,0,0,0,0,6,3,66,22,0,2,45,3,66,0.5,11,3,22,66,0,0
Courtland Sutton,326.2,26,17,16,0,0,0,0,0,0,0,0,98,58,776,13.4,2,35,55,3.4,45.6,0.592,7.9,58,13.4,776,2,0
Cordarrelle Patterson,193.3,22,16,6,12,158,3,7,50,13.2,9.9,0.8,77,45,469,10.4,4,19,79,2.8,29.3,0.584,6.1,57,11,627,7,0
Cordarrelle Patterson,7.5,23,16,7,10,117,1,4,67,11.7,7.3,0.6,67,33,384,11.6,1,20,28,2.1,24,0.493,5.7,43,11.7,501,2,1
Cordarrelle Patterson,208.8,24,16,1,2,15,0,1,9,7.5,0.9,0.1,2,2,10,5,0,1,9,0.1,0.6,1,5,4,6.3,25,0,1
Cordarrelle Patterson,166,25,16,8,7,43,0,2,22,6.1,2.7,0.4,70,52,453,8.7,2,23,39,3.3,28.3,0.743,6.5,59,8.4,496,2,2
Cordarrelle Patterson,185.5,26,16,2,13,121,2,3,47,9.3,7.6,0.8,42,31,309,10,0,14,59,1.9,19.3,0.738,7.4,44,9.8,430,2,3
Cordarrelle Patterson,66.8,27,15,5,42,228,1,15,27,5.4,15.2,2.8,28,21,247,11.8,3,11,55,1.4,16.5,0.75,8.8,63,7.5,475,4,1
Cordarrelle Patterson,136.2,28,16,4,17,103,0,4,46,6.1,6.4,1.1,17,11,83,7.5,0,3,33,0.7,5.2,0.647,4.9,28,6.6,186,0,0
Cordarrelle Patterson,463.8,29,16,3,64,232,1,12,13,3.6,14.5,4,25,21,132,6.3,0,7,25,1.3,8.3,0.84,5.3,85,4.3,364,1,0
Cordarrelle Patterson,312.1,30,16,13,153,618,6,29,39,4,38.6,9.6,69,52,548,10.5,5,26,64,3.3,34.3,0.754,7.9,205,5.7,1166,11,2
Jerick McKinnon,172.2,22,11,6,113,538,0,24,55,4.8,48.9,10.3,41,27,135,5,0,7,17,2.5,12.3,0.659,3.3,140,4.8,673,0,0
Jerick McKinnon,305.2,23,16,0,52,271,2,13,68,5.2,16.9,3.3,29,21,173,8.2,1,9,30,1.3,10.8,0.724,6,73,6.1,444,3,0
Jerick McKinnon,372.3,24,15,7,159,539,2,21,36,3.4,35.9,10.6,53,43,255,5.9,2,17,41,2.9,17,0.811,4.8,202,3.9,794,4,0
Jerick McKinnon,240.6,25,16,1,150,570,3,24,58,3.8,35.6,9.4,68,51,421,8.3,2,20,41,3.2,26.3,0.75,6.2,201,4.9,991,5,3
Jerick McKinnon,69.7,28,16,4,81,319,5,16,55,3.9,19.9,5.1,46,33,253,7.7,1,12,26,2.1,15.8,0.717,5.5,114,5,572,6,0
Jerick McKinnon,354.9,29,13,0,12,62,0,2,18,5.2,4.8,0.9,20,13,107,8.2,1,6,14,1,8.2,0.65,5.4,25,6.8,169,1,0
Jakobi Meyers,278.4,23,15,1,0,0,0,0,0,0,0,0,41,26,359,13.8,0,17,35,1.7,23.9,0.634,8.8,26,13.8,359,0,0
Jakobi Meyers,355.5,24,14,9,2,9,0,0,7,4.5,0.6,0.1,81,59,729,12.4,0,37,35,4.2,52.1,0.728,9,61,12.1,738,0,1
Jakobi Meyers,336.9,25,17,16,1,9,0,0,9,9,0.5,0.1,126,83,866,10.4,2,42,39,4.9,50.9,0.659,6.9,84,10.4,875,2,1
Allen Lazard,202.4,23,1,0,0,0,0,0,0,0,0,0,1,1,7,7,0,0,7,1,7,1,7,1,7,7,0,0
Allen Lazard,191.4,24,16,3,1,21,0,1,21,21,1.3,0.1,52,35,477,13.6,3,24,43,2.2,29.8,0.673,9.2,36,13.8,498,3,0
Allen Lazard,251.5,25,10,9,2,17,0,1,19,8.5,1.7,0.2,46,33,451,13.7,3,23,72,3.3,45.1,0.717,9.8,35,13.4,468,3,0
Allen Lazard,332.4,26,15,13,3,32,0,2,14,10.7,2.1,0.2,60,40,513,12.8,8,28,42,2.7,34.2,0.667,8.6,43,12.7,545,8,0
Evan Engram,246.9,23,15,11,1,14,0,1,14,14,0.9,0.1,115,64,722,11.3,6,37,35,4.3,48.1,0.557,6.3,65,11.3,736,6,0
Evan Engram,204.2,24,11,8,3,36,0,3,14,12,3.3,0.3,64,45,577,12.8,3,22,54,4.1,52.5,0.703,9,48,12.8,613,3,0
Evan Engram,277,25,8,6,3,7,0,0,5,2.3,0.9,0.4,68,44,467,10.6,3,23,75,5.5,58.4,0.647,6.9,47,10.1,474,3,0
Evan Engram,183.5,26,16,14,6,26,1,1,9,4.3,1.6,0.4,109,63,654,10.4,1,31,53,3.9,40.9,0.578,6,69,9.9,680,2,1
Evan Engram,330.7,27,15,12,1,-3,0,0,-3,-3,-0.2,0.1,73,46,408,8.9,3,21,30,3.1,27.2,0.63,5.6,47,8.6,405,3,1
George Kittle,534.1,24,15,7,0,0,0,0,0,0,0,0,63,43,515,12,2,24,44,2.9,34.3,0.683,8.2,43,12,515,2,0
George Kittle,435.5,25,16,16,1,10,0,1,10,10,0.6,0.1,136,88,1377,15.6,5,60,85,5.5,86.1,0.647,10.1,89,15.6,1387,5,0
George Kittle,255.3,26,14,14,5,22,0,1,18,4.4,1.6,0.4,107,85,1053,12.4,5,53,61,6.1,75.2,0.794,9.8,90,11.9,1075,5,1
George Kittle,382,27,8,8,2,17,0,1,9,8.5,2.1,0.3,63,48,634,13.2,2,32,44,6,79.3,0.762,10.1,50,13,651,2,0
George Kittle,353.5,28,14,14,3,20,0,0,9,6.7,1.4,0.2,94,71,910,12.8,6,42,48,5.1,65,0.755,9.7,74,12.6,930,6,2
Tyler Boyd,101.5,22,16,2,4,58,0,2,39,14.5,3.6,0.3,81,54,603,11.2,1,33,30,3.4,37.7,0.667,7.4,58,11.4,661,1,1
Tyler Boyd,427.3,23,10,1,0,0,0,0,0,0,0,0,32,22,225,10.2,2,14,49,2.2,22.5,0.688,7,22,10.2,225,2,0
Tyler Boyd,436.7,24,14,14,2,3,0,0,5,1.5,0.2,0.1,108,76,1028,13.5,7,54,49,5.4,73.4,0.704,9.5,78,13.2,1031,7,0
Tyler Boyd,368,25,16,15,4,23,0,1,10,5.8,1.4,0.3,148,90,1046,11.6,5,51,47,5.6,65.4,0.608,7.1,94,11.4,1069,5,2
Tyler Boyd,350,26,15,8,5,49,0,2,25,9.8,3.3,0.3,110,79,841,10.6,4,43,72,5.3,56.1,0.718,7.6,84,10.6,890,4,1
Tyler Boyd,316.6,27,16,10,2,22,0,1,14,11,1.4,0.1,94,67,828,12.4,5,37,68,4.2,51.8,0.713,8.8,69,12.3,850,5,1
Keenan Allen,331.9,21,15,14,0,0,0,0,0,0,0,0,105,71,1046,14.7,8,54,43,4.7,69.7,0.676,10,71,14.7,1046,8,2
Keenan Allen,306.5,22,14,14,0,0,0,0,0,0,0,0,121,77,783,10.2,4,41,35,5.5,55.9,0.636,6.5,77,10.2,783,4,2
Keenan Allen,24.9,23,8,8,0,0,0,0,0,0,0,0,89,67,725,10.8,4,34,38,8.4,90.6,0.753,8.1,67,10.8,725,4,1
Keenan Allen,556.6,24,1,1,0,0,0,0,0,0,0,0,7,6,63,10.5,0,6,15,6,63,0.857,9,6,10.5,63,0,0
Keenan Allen,508.3,25,16,15,2,9,0,0,6,4.5,0.6,0.1,159,102,1393,13.7,6,74,51,6.4,87.1,0.642,8.8,104,13.5,1402,6,1
Keenan Allen,504.5,26,16,14,9,75,0,4,28,8.3,4.7,0.6,136,97,1196,12.3,6,62,54,6.1,74.8,0.713,8.8,106,12,1271,6,3
Keenan Allen,439.3,27,16,16,3,16,0,1,18,5.3,1,0.2,149,104,1199,11.5,6,63,45,6.5,74.9,0.698,8,107,11.4,1215,6,0
Keenan Allen,481.4,28,14,13,1,-1,0,0,-1,-1,-0.1,0.1,147,100,992,9.9,8,61,28,7.1,70.9,0.68,6.7,101,9.8,991,8,3
Keenan Allen,316,29,16,16,0,0,0,0,0,0,0,0,157,106,1138,10.7,6,66,42,6.6,71.1,0.675,7.2,106,10.7,1138,6,1
Mack Hollins,47.5,24,16,0,0,0,0,0,0,0,0,0,22,16,226,14.1,1,8,64,1,14.1,0.727,10.3,16,14.1,226,1,0
Mack Hollins,0,26,16,3,0,0,0,0,0,0,0,0,23,10,125,12.5,0,7,20,0.6,7.8,0.435,5.4,10,12.5,125,0,0
Mack Hollins,47.5,0,4,0,0,0,0,0,0,0,0,0,1,0,0,0,0,0,0,0,0,0,0,0,0,0,0,0
Mack Hollins,72.8,0,12,3,0,0,0,0,0,0,0,0,22,10,125,12.5,0,7,20,0.8,10.4,0.455,5.7,10,12.5,125,0,0
Mack Hollins,104.9,27,16,2,0,0,0,0,0,0,0,0,25,16,176,11,1,7,34,1,11,0.64,7,16,11,176,1,1
Mack Hollins,300,28,17,3,0,0,0,0,0,0,0,0,28,14,223,15.9,4,11,65,0.8,13.1,0.5,8,14,15.9,223,4,0
Darius Slayton,291,22,14,9,0,0,0,0,0,0,0,0,84,48,740,15.4,8,32,55,3.4,52.9,0.571,8.8,48,15.4,740,8,0
Darius Slayton,133.8,23,16,15,2,-1,0,0,2,-0.5,-0.1,0.1,96,50,751,15,3,40,41,3.1,46.9,0.521,7.8,52,14.4,750,3,1
Darius Slayton,271.2,24,13,5,1,-13,0,0,-13,-13,-1,0.1,58,26,339,13,2,14,42,2,26.1,0.448,5.8,27,12.1,326,2,1
Adam Thielen,81.9,24,16,2,0,0,0,0,0,0,0,0,13,8,137,17.1,1,7,44,0.5,8.6,0.615,10.5,8,17.1,137,1,0
Adam Thielen,389.6,25,16,2,4,89,0,4,41,22.3,5.6,0.3,18,12,144,12,0,5,30,0.8,9,0.667,8,16,14.6,233,0,0
Adam Thielen,495.1,26,16,10,2,15,0,1,11,7.5,0.9,0.1,92,69,967,14,5,44,71,4.3,60.4,0.75,10.5,71,13.8,982,5,2
Adam Thielen,585.9,27,16,16,1,11,0,1,11,11,0.7,0.1,142,91,1276,14,4,59,65,5.7,79.8,0.641,9,92,14,1287,4,3
Adam Thielen,199.2,28,16,16,5,30,0,1,15,6,1.9,0.3,153,113,1373,12.2,9,74,68,7.1,85.8,0.739,9,118,11.9,1403,9,1
Adam Thielen,440,29,10,10,4,6,1,1,3,1.5,0.6,0.4,48,30,418,13.9,6,18,44,3,41.8,0.625,8.7,34,12.5,424,7,0
Adam Thielen,343.4,30,15,15,3,15,0,0,8,5,1,0.2,108,74,925,12.5,14,52,51,4.9,61.7,0.685,8.6,77,12.2,940,14,0
Adam Thielen,322,31,13,13,1,2,0,0,2,2,0.2,0.1,95,67,726,10.8,10,37,35,5.2,55.8,0.705,7.6,68,10.7,728,10,1
DeAndre Hopkins,471,21,16,16,0,0,0,0,0,0,0,0,91,52,802,15.4,2,38,66,3.3,50.1,0.571,8.8,52,15.4,802,2,1
DeAndre Hopkins,631.3,22,16,16,0,0,0,0,0,0,0,0,127,76,1210,15.9,6,57,76,4.8,75.6,0.598,9.5,76,15.9,1210,6,2
DeAndre Hopkins,388.2,23,16,16,0,0,0,0,0,0,0,0,192,111,1521,13.7,11,83,61,6.9,95.1,0.578,7.9,111,13.7,1521,11,1
DeAndre Hopkins,585.4,24,16,16,0,0,0,0,0,0,0,0,151,78,954,12.2,4,57,51,4.9,59.6,0.517,6.3,78,12.2,954,4,0
DeAndre Hopkins,646.5,25,15,15,0,0,0,0,0,0,0,0,174,96,1378,14.4,13,69,72,6.4,91.9,0.552,7.9,96,14.4,1378,13,1
DeAndre Hopkins,500.9,26,16,16,1,-7,0,0,-7,-7,-0.4,0.1,163,115,1572,13.7,11,81,49,7.2,98.3,0.706,9.6,116,13.5,1565,11,2
DeAndre Hopkins,567.4,27,15,15,2,18,0,2,12,9,1.2,0.1,150,104,1165,11.2,7,68,43,6.9,77.7,0.693,7.8,106,11.2,1183,7,0
DeAndre Hopkins,261.6,28,16,16,1,1,0,0,1,1,0.1,0.1,160,115,1407,12.2,6,75,60,7.2,87.9,0.719,8.8,116,12.1,1408,6,3
DeAndre Hopkins,293.1,29,10,10,0,0,0,0,0,0,0,0,64,42,572,13.6,8,32,55,4.2,57.2,0.656,8.9,42,13.6,572,8,0
Marquise Brown,337,22,14,11,0,0,0,0,0,0,0,0,71,46,584,12.7,7,24,83,3.3,41.7,0.648,8.2,46,12.7,584,7,0
Marquise Brown,424.9,23,16,14,1,1,0,0,1,1,0.1,0.1,100,58,769,13.3,8,35,70,3.6,48.1,0.58,7.7,59,13.1,770,8,0
Marquise Brown,296,24,16,16,1,5,0,1,5,5,0.3,0.1,146,91,1008,11.1,6,41,49,5.7,63,0.623,6.9,92,11,1013,6,3
Brandin Cooks,482.8,21,10,7,7,73,1,4,28,10.4,7.3,0.7,69,53,550,10.4,3,25,50,5.3,55,0.768,8,60,10.4,623,4,1
Brandin Cooks,484.9,22,16,12,8,18,0,2,11,2.3,1.1,0.5,129,84,1138,13.5,9,45,71,5.3,71.1,0.651,8.8,92,12.6,1156,9,1
Brandin Cooks,443.6,23,16,12,6,30,0,1,11,5,1.9,0.4,117,78,1173,15,8,46,98,4.9,73.3,0.667,10,84,14.3,1203,8,1
Brandin Cooks,495.6,24,16,15,9,40,0,2,13,4.4,2.5,0.6,114,65,1082,16.6,7,42,64,4.1,67.6,0.57,9.5,74,15.2,1122,7,0
Brandin Cooks,244.5,25,16,16,10,68,1,5,17,6.8,4.3,0.6,117,80,1204,15.1,5,56,57,5,75.3,0.684,10.3,90,14.1,1272,6,1
Brandin Cooks,462,26,14,14,6,52,0,3,27,8.7,3.7,0.4,72,42,583,13.9,2,32,57,3,41.6,0.583,8.1,48,13.2,635,2,0
Brandin Cooks,443.4,27,15,15,0,0,0,0,0,0,0,0,119,81,1150,14.2,6,51,57,5.4,76.7,0.681,9.7,81,14.2,1150,6,0
Brandin Cooks,286.8,28,16,16,2,21,0,1,16,10.5,1.3,0.1,134,90,1037,11.5,6,45,52,5.6,64.8,0.672,7.7,92,11.5,1058,6,0
Dallas Goedert,266.1,23,16,8,0,0,0,0,0,0,0,0,44,33,334,10.1,4,15,32,2.1,20.9,0.75,7.6,33,10.1,334,4,0
Dallas Goedert,221.2,24,15,9,0,0,0,0,0,0,0,0,87,58,607,10.5,5,33,28,3.9,40.5,0.667,7,58,10.5,607,5,2
Dallas Goedert,327,25,11,9,0,0,0,0,0,0,0,0,65,46,524,11.4,3,28,41,4.2,47.6,0.708,8.1,46,11.4,524,3,0
Dallas Goedert,281.6,26,15,14,0,0,0,0,0,0,0,0,76,56,830,14.8,4,42,45,3.7,55.3,0.737,10.9,56,14.8,830,4,1
Marquez Valdes-Scantling,176.3,24,16,10,2,29,0,2,21,14.5,1.8,0.1,73,38,581,15.3,2,23,60,2.4,36.3,0.521,8,40,15.3,610,2,0
Marquez Valdes-Scantling,277.9,25,16,10,2,9,0,0,9,4.5,0.6,0.1,56,26,452,17.4,2,14,74,1.6,28.3,0.464,8.1,28,16.5,461,2,0
Marquez Valdes-Scantling,173,26,16,12,4,13,0,1,9,3.3,0.8,0.3,63,33,690,20.9,6,27,78,2.1,43.1,0.524,11,37,19,703,6,1
Marquez Valdes-Scantling,259.2,27,11,7,0,0,0,0,0,0,0,0,55,26,430,16.5,3,18,75,2.4,39.1,0.473,7.8,26,16.5,430,3,0
Parris Campbell,32.1,22,7,3,4,34,0,1,22,8.5,4.9,0.6,24,18,127,7.1,1,6,27,2.6,18.1,0.75,5.3,22,7.3,161,1,3
Parris Campbell,64.6,23,2,2,2,16,0,2,9,8,8,1,9,6,71,11.8,0,4,21,3,35.5,0.667,7.9,8,10.9,87,0,0
Parris Campbell,283.3,24,6,3,0,0,0,0,0,0,0,0,20,10,162,16.2,1,7,51,1.7,27,0.5,8.1,10,16.2,162,1,0
Samaje Perine,14.1,22,16,8,175,603,1,23,30,3.4,37.7,10.9,24,22,182,8.3,1,9,25,1.4,11.4,0.917,7.6,197,4,785,2,2
Samaje Perine,0,23,5,0,8,32,0,2,11,4,6.4,1.6,4,3,5,1.7,0,0,8,0.6,1,0.75,1.3,11,3.4,37,0,0
Samaje Perine,0,24,7,0,5,16,0,1,9,3.2,2.3,0.7,0,0,0,0,0,0,0,0,0,0,0,5,3.2,16,0,0
Samaje Perine,0,0,6,0,0,0,0,0,0,0,0,0,0,0,0,0,0,0,0,0,0,0,0,0,0,0,0,0
Samaje Perine,139.1,0,1,0,5,16,0,1,9,3.2,16,5,0,0,0,0,0,0,0,0,0,0,0,5,3.2,16,0,0
Samaje Perine,171.6,25,16,1,63,301,3,16,46,4.8,18.8,3.9,12,11,66,6,0,4,15,0.7,4.1,0.917,5.5,74,5,367,3,0
Samaje Perine,278.3,26,16,0,55,246,1,11,46,4.5,15.4,3.4,31,27,196,7.3,1,9,23,1.7,12.3,0.871,6.3,82,5.4,442,2,0
Kareem Hunt,470.6,22,16,16,272,1327,8,63,69,4.9,82.9,17,63,53,455,8.6,3,17,78,3.3,28.4,0.841,7.2,325,5.5,1782,11,1
Kareem Hunt,192.2,23,11,11,181,824,7,46,45,4.6,74.9,16.5,35,26,378,14.5,7,16,67,2.4,34.4,0.743,10.8,207,5.8,1202,14,0
Kareem Hunt,443.5,24,8,3,43,179,2,8,16,4.2,22.4,5.4,44,37,285,7.7,1,17,29,4.6,35.6,0.841,6.5,80,5.8,464,3,1
Kareem Hunt,220,25,16,5,198,841,6,44,33,4.2,52.6,12.4,51,38,304,8,5,19,26,2.4,19,0.745,6,236,4.9,1145,11,2
Kareem Hunt,260.4,26,8,1,78,386,5,22,33,4.9,48.3,9.8,27,22,174,7.9,0,10,23,2.8,21.8,0.815,6.4,100,5.6,560,5,0
K.J. Osborn,291.5,23,9,0,0,0,0,0,0,0,0,0,0,0,0,0,0,0,0,0,0,0,0,0,0,0,0,2
K.J. Osborn,284.8,24,17,9,1,10,0,1,10,10,0.6,0.1,82,50,655,13.1,7,26,64,2.9,38.5,0.61,8,51,13,665,7,0
Taysom Hill,73,27,5,0,0,0,0,0,0,0,0,0,0,0,0,0,0,0,0,0,0,0,0,0,0,0,0,0
Taysom Hill,178,28,16,4,37,196,2,15,35,5.3,12.3,2.3,7,3,4,1.3,0,0,5,0.2,0.3,0.429,0.6,40,5,200,2,1
Taysom Hill,208.5,29,16,5,27,156,1,10,30,5.8,9.8,1.7,22,19,234,12.3,6,14,45,1.2,14.6,0.864,10.6,46,8.5,390,7,0
Taysom Hill,157.8,30,16,8,87,457,8,34,43,5.3,28.6,5.4,12,8,98,12.3,1,4,21,0.5,6.1,0.667,8.2,95,5.8,555,9,10
Taysom Hill,254.6,31,12,9,70,374,5,26,44,5.3,31.2,5.8,6,4,52,13,0,4,15,0.3,4.3,0.667,8.7,74,5.8,426,5,2
Kalif Raymond,-5.7,22,4,0,0,0,0,0,0,0,0,0,2,0,0,0,0,0,0,0,0,0,0,0,0,0,0,2
Kalif Raymond,0.3,23,8,0,1,-1,0,0,0,-1,-0.1,0.1,1,1,12,12,0,0,12,0.1,1.5,1,12,2,5.5,11,0,5
Kalif Raymond,0,0,6,0,1,-1,0,0,-1,-1,-0.2,0.2,1,1,12,12,0,1,12,0.2,2,1,12,2,5.5,11,0,2
Kalif Raymond,62.5,0,2,0,0,0,0,0,0,0,0,0,0,0,0,0,0,0,0,0,0,0,0,0,0,0,0,3
Kalif Raymond,64.2,25,8,1,1,-5,0,0,-5,-5,-0.6,0.1,12,9,170,18.9,1,6,52,1.1,21.3,0.75,14.2,10,16.5,165,1,1
Kalif Raymond,253.2,26,15,3,1,-3,0,0,-3,-3,-0.2,0.1,15,9,187,20.8,0,7,61,0.6,12.5,0.6,12.5,10,18.4,184,0,0
Kalif Raymond,236.6,27,16,14,4,28,0,2,13,7,1.8,0.3,71,48,576,12,4,28,75,3,36,0.676,8.1,52,11.6,604,4,0
Tyler Higbee,119.5,23,16,7,0,0,0,0,0,0,0,0,29,11,85,7.7,1,3,31,0.7,5.3,0.379,2.9,11,7.7,85,1,0
Tyler Higbee,121.6,24,16,16,0,0,0,0,0,0,0,0,45,25,295,11.8,1,12,38,1.6,18.4,0.556,6.6,25,11.8,295,1,0
Tyler Higbee,307.2,25,16,16,0,0,0,0,0,0,0,0,34,24,292,12.2,2,16,36,1.5,18.3,0.706,8.6,24,12.2,292,2,1
Tyler Higbee,230.6,26,15,15,0,0,0,0,0,0,0,0,89,69,734,10.6,3,36,33,4.6,48.9,0.775,8.2,69,10.6,734,3,0
Tyler Higbee,257,27,15,15,1,1,0,0,1,1,0.1,0.1,60,44,521,11.8,5,27,44,2.9,34.7,0.733,8.7,45,11.6,522,5,0
Tyler Higbee,276,28,15,15,0,0,0,0,0,0,0,0,85,61,560,9.2,5,33,37,4.1,37.3,0.718,6.6,61,9.2,560,5,1
David Njoku,271.7,21,16,5,1,1,0,0,1,1,0.1,0.1,60,32,386,12.1,4,17,34,2,24.1,0.533,6.4,33,11.7,387,4,0
David Njoku,23.3,22,16,14,0,0,0,0,0,0,0,0,88,56,639,11.4,4,27,66,3.5,39.9,0.636,7.3,56,11.4,639,4,0
David Njoku,94.9,23,4,1,0,0,0,0,0,0,0,0,10,5,41,8.2,1,3,18,1.3,10.3,0.5,4.1,5,8.2,41,1,0
David Njoku,202.8,24,13,5,0,0,0,0,0,0,0,0,29,19,213,11.2,2,13,28,1.5,16.4,0.655,7.3,19,11.2,213,2,0
David Njoku,266,25,16,11,1,1,0,0,1,1,0.1,0.1,53,36,475,13.2,4,17,71,2.3,29.7,0.679,9,37,12.9,476,4,0
Dalton Schultz,2.8,22,11,7,0,0,0,0,0,0,0,0,17,12,116,9.7,0,6,17,1.1,10.5,0.706,6.8,12,9.7,116,0,0
Dalton Schultz,269.5,23,16,0,0,0,0,0,0,0,0,0,2,1,6,6,0,0,6,0.1,0.4,0.5,3,1,6,6,0,0
Dalton Schultz,368.4,24,16,14,0,0,0,0,0,0,0,0,89,63,615,9.8,4,33,28,3.9,38.4,0.708,6.9,63,9.8,615,4,1
Dalton Schultz,258.1,25,17,15,0,0,0,0,0,0,0,0,104,78,808,10.4,8,43,32,4.6,47.5,0.75,7.8,78,10.4,808,8,0
Richie James,59.2,23,13,2,0,0,0,0,0,0,0,0,14,9,130,14.4,1,4,53,0.7,10,0.643,9.3,9,14.4,130,1,2
Richie James,143.2,24,16,1,2,-1,0,0,0,-0.5,-0.1,0.1,10,6,165,27.5,1,5,57,0.4,10.3,0.6,16.5,8,20.5,164,1,1
Richie James,247.5,25,11,7,0,0,0,0,0,0,0,0,35,23,394,17.1,1,15,47,2.1,35.8,0.657,11.3,23,17.1,394,1,2
Kenyan Drake,316.9,22,16,1,33,179,2,9,45,5.4,11.2,2.1,10,9,46,5.1,0,2,9,0.6,2.9,0.9,4.6,42,5.4,225,2,1
Kenyan Drake,406.6,23,16,6,133,644,3,26,66,4.8,40.3,8.3,48,32,239,7.5,1,7,47,2,14.9,0.667,5,165,5.4,883,4,2
Kenyan Drake,442.6,24,16,7,120,535,4,23,54,4.5,33.4,7.5,73,53,477,9,5,23,52,3.3,29.8,0.726,6.5,173,5.8,1012,9,2
Kenyan Drake,320.2,25,14,10,170,817,8,48,80,4.8,58.4,12.1,68,50,345,6.9,0,15,26,3.6,24.6,0.735,5.1,220,5.3,1162,8,2
Kenyan Drake,122.4,0,8,8,123,643,8,42,80,5.2,80.4,15.4,35,28,171,6.1,0,9,21,3.5,21.4,0.8,4.9,151,5.4,814,8,0
Kenyan Drake,406.6,0,6,2,47,174,0,6,11,3.7,29,7.8,33,22,174,7.9,0,6,26,3.7,29,0.667,5.3,69,5,348,0,2
Kenyan Drake,209.5,26,15,13,239,955,10,59,69,4,63.7,15.9,31,25,137,5.5,0,5,18,1.7,9.1,0.806,4.4,264,4.1,1092,10,3
Kenyan Drake,216.3,27,12,2,63,254,2,15,21,4,21.2,5.3,40,30,291,9.7,1,12,31,2.5,24.3,0.75,7.3,93,5.9,545,3,1
Damien Harris,237.9,22,2,0,4,12,0,0,13,3,6,2,0,0,0,0,0,0,0,0,0,0,0,4,3,12,0,0
Damien Harris,422.3,23,10,10,137,691,2,30,41,5,69.1,13.7,7,5,52,10.4,0,4,15,0.5,5.2,0.714,7.4,142,5.2,743,2,1
Damien Harris,202.7,24,15,15,202,929,15,55,64,4.6,61.9,13.5,21,18,132,7.3,0,4,21,1.2,8.8,0.857,6.3,220,4.8,1061,15,2
Noah Brown,21.2,21,13,1,0,0,0,0,0,0,0,0,9,4,33,8.3,0,3,14,0.3,2.5,0.444,3.7,4,8.3,33,0,0
Noah Brown,61.4,22,8,2,0,0,0,0,0,0,0,0,8,5,54,10.8,0,2,22,0.6,6.8,0.625,6.8,5,10.8,54,0,0
Noah Brown,71.2,24,16,1,1,4,0,0,4,4,0.3,0.1,24,14,154,11,0,6,20,0.9,9.6,0.583,6.4,15,10.5,158,0,0
Noah Brown,225.5,25,13,1,0,0,0,0,0,0,0,0,25,16,184,11.5,0,6,27,1.2,14.2,0.64,7.4,16,11.5,184,0,0
Tyler Conklin,25.4,23,16,3,0,0,0,0,0,0,0,0,7,5,77,15.4,0,3,33,0.3,4.8,0.714,11,5,15.4,77,0,0
Tyler Conklin,81.2,24,15,1,0,0,0,0,0,0,0,0,10,8,58,7.3,0,2,20,0.5,3.9,0.8,5.8,8,7.3,58,0,0
Tyler Conklin,254.9,25,16,2,0,0,0,0,0,0,0,0,26,19,194,10.2,1,11,30,1.2,12.1,0.731,7.5,19,10.2,194,1,1
Tyler Conklin,238.5,26,17,15,0,0,0,0,0,0,0,0,87,61,593,9.7,3,26,40,3.6,34.9,0.701,6.8,61,9.7,593,3,1
Gerald Everett,151.8,23,16,2,1,13,0,1,13,13,0.8,0.1,32,16,244,15.3,2,6,69,1,15.3,0.5,7.6,17,15.1,257,2,1
Gerald Everett,171.4,24,16,0,2,16,0,1,12,8,1,0.1,50,33,320,9.7,3,16,40,2.1,20,0.66,6.4,35,9.6,336,3,0
Gerald Everett,176.7,25,13,2,1,0,0,0,0,0,0,0.1,60,37,408,11,2,22,33,2.8,31.4,0.617,6.8,38,10.7,408,2,0
Gerald Everett,217.4,26,16,7,1,2,1,1,2,2,0.1,0.1,62,41,417,10.2,1,24,40,2.6,26.1,0.661,6.7,42,10,419,2,1
Gerald Everett,248.5,27,15,12,3,20,0,2,13,6.7,1.3,0.2,63,48,478,10,4,26,41,3.2,31.9,0.762,7.6,51,9.8,498,4,2
Cole Kmet,243.6,21,16,9,1,-3,0,0,-3,-3,-0.2,0.1,44,28,243,8.7,2,12,38,1.8,15.2,0.636,5.5,29,8.3,240,2,1
Cole Kmet,255.9,22,17,17,1,0,0,0,0,0,0,0.1,93,60,612,10.2,0,29,25,3.5,36,0.645,6.6,61,10,612,0,0
Chris Moore,107.7,23,15,0,3,19,0,1,10,6.3,1.3,0.2,16,7,46,6.6,0,2,13,0.5,3.1,0.438,2.9,10,6.5,65,0,1
Chris Moore,88.9,24,13,4,2,-9,0,0,-4,-4.5,-0.7,0.2,38,18,248,13.8,3,11,30,1.4,19.1,0.474,6.5,20,12,239,3,0
Chris Moore,9.3,25,16,0,5,17,0,1,9,3.4,1.1,0.3,25,19,196,10.3,1,8,30,1.2,12.3,0.76,7.8,24,8.9,213,1,0
Chris Moore,0,26,14,1,1,0,0,0,0,0,0,0.1,5,3,21,7,0,0,13,0.2,1.5,0.6,4.2,4,5.3,21,0,0
Chris Moore,101.1,27,3,0,0,0,0,0,0,0,0,0,0,0,0,0,0,0,0,0,0,0,0,0,0,0,0,0
Chris Moore,225.3,28,12,1,0,0,0,0,0,0,0,0,22,21,227,10.8,2,6,67,1.8,18.9,0.955,10.3,21,10.8,227,2,0
Melvin Gordon,533.8,22,14,12,184,641,0,36,27,3.5,45.8,13.1,37,33,192,5.8,0,8,18,2.4,13.7,0.892,5.2,217,3.8,833,0,6
Melvin Gordon,602.3,23,13,11,254,997,10,62,48,3.9,76.7,19.5,57,41,419,10.2,2,21,35,3.2,32.2,0.719,7.4,295,4.8,1416,12,2
Melvin Gordon,544.5,24,16,16,284,1105,8,61,87,3.9,69.1,17.8,83,58,476,8.2,4,22,49,3.6,29.8,0.699,5.7,342,4.6,1581,12,1
Melvin Gordon,360.4,25,12,12,175,885,10,47,34,5.1,73.8,14.6,66,50,490,9.8,4,21,66,4.2,40.8,0.758,7.4,225,6.1,1375,14,1
Melvin Gordon,427.2,26,12,11,162,612,8,39,24,3.8,51,13.5,55,42,296,7,1,11,25,3.5,24.7,0.764,5.4,204,4.5,908,9,4
Melvin Gordon,421.3,27,15,10,215,986,9,46,65,4.6,65.7,14.3,44,32,158,4.9,1,7,20,2.1,10.5,0.727,3.6,247,4.6,1144,10,4
Melvin Gordon,189.3,28,16,16,203,918,8,48,70,4.5,57.4,12.7,38,28,213,7.6,2,9,30,1.8,13.3,0.737,5.6,231,4.9,1131,10,3
Olamide Zaccheaus,108.2,22,10,0,0,0,0,0,0,0,0,0,5,3,115,38.3,1,2,93,0.3,11.5,0.6,23,3,38.3,115,1,0
Olamide Zaccheaus,171.4,23,11,2,1,0,0,0,0,0,0,0.1,32,20,274,13.7,1,16,51,1.8,24.9,0.625,8.6,21,13,274,1,0
Olamide Zaccheaus,218,24,17,8,1,2,0,1,2,2,0.1,0.1,53,31,406,13.1,3,22,49,1.8,23.9,0.585,7.7,32,12.8,408,3,0
DeVante Parker,303.2,22,14,4,0,0,0,0,0,0,0,0,50,26,494,19,3,20,49,1.9,35.3,0.52,9.9,26,19,494,3,0
DeVante Parker,262,23,15,8,0,0,0,0,0,0,0,0,87,56,744,13.3,4,35,56,3.7,49.6,0.644,8.6,56,13.3,744,4,0
DeVante Parker,122.7,24,13,12,0,0,0,0,0,0,0,0,96,57,670,11.8,1,34,36,4.4,51.5,0.594,7,57,11.8,670,1,1
DeVante Parker,486.6,25,11,7,0,0,0,0,0,0,0,0,47,24,309,12.9,1,14,46,2.2,28.1,0.511,6.6,24,12.9,309,1,0
DeVante Parker,322.9,26,16,14,0,0,0,0,0,0,0,0,128,72,1202,16.7,9,58,51,4.5,75.1,0.563,9.4,72,16.7,1202,9,0
DeVante Parker,206.5,27,14,11,0,0,0,0,0,0,0,0,103,63,793,12.6,4,45,31,4.5,56.6,0.612,7.7,63,12.6,793,4,1
DeVante Parker,210.7,28,10,8,0,0,0,0,0,0,0,0,73,40,515,12.9,2,29,42,4,51.5,0.548,7.1,40,12.9,515,2,0
Corey Davis,370.8,22,11,9,0,0,0,0,0,0,0,0,65,34,375,11,0,17,37,3.1,34.1,0.523,5.8,34,11,375,0,1
Corey Davis,233.3,23,16,16,6,55,0,2,39,9.2,3.4,0.4,112,65,891,13.7,4,47,51,4.1,55.7,0.58,8,71,13.3,946,4,1
Corey Davis,388.2,24,15,11,0,0,0,0,0,0,0,0,69,43,601,14,2,33,38,2.9,40.1,0.623,8.7,43,14,601,2,1
Corey Davis,201.6,25,14,12,0,0,0,0,0,0,0,0,92,65,984,15.1,5,49,75,4.6,70.3,0.707,10.7,65,15.1,984,5,1
Corey Davis,204.8,26,9,9,0,0,0,0,0,0,0,0,59,34,492,14.5,4,23,53,3.8,54.7,0.576,8.3,34,14.5,492,4,2
Marvin Jones,302.7,21,14,14,2,16,0,1,13,8,1.1,0.1,85,40,587,14.7,3,26,57,2.9,41.9,0.471,6.9,42,14.4,603,3,0
Robert Woods,226.6,22,16,15,0,0,0,0,0,0,0,0,104,65,699,10.8,5,35,37,4.1,43.7,0.625,6.7,65,10.8,699,5,1
Robert Woods,242.7,23,14,9,1,0,0,0,0,0,0,0.1,80,47,552,11.7,3,27,37,3.4,39.4,0.588,6.9,48,11.5,552,3,2
Robert Woods,321.9,24,13,10,1,6,0,1,6,6,0.5,0.1,76,51,613,12,1,34,34,3.9,47.2,0.671,8.1,52,11.9,619,1,0
Robert Woods,540.8,25,12,11,2,12,0,0,8,6,1,0.2,85,56,781,13.9,5,36,94,4.7,65.1,0.659,9.2,58,13.7,793,5,1
Robert Woods,482.7,26,16,16,19,157,1,9,56,8.3,9.8,1.2,130,86,1219,14.2,6,66,39,5.4,76.2,0.662,9.4,105,13.1,1376,7,0
Robert Woods,461.3,27,15,15,17,115,1,5,20,6.8,7.7,1.1,139,90,1134,12.6,2,54,48,6,75.6,0.647,8.2,107,11.7,1249,3,0
Robert Woods,255.6,28,16,16,24,155,2,9,40,6.5,9.7,1.5,129,90,936,10.4,6,46,56,5.6,58.5,0.698,7.3,114,9.6,1091,8,2
Robert Woods,221.1,29,9,9,8,46,1,1,16,5.8,5.1,0.9,69,45,556,12.4,4,34,28,5,61.8,0.652,8.1,53,11.4,602,5,0
Robert Woods,72.6,25,14,4,1,7,0,0,7,7,0.5,0.1,25,22,216,9.8,0,10,50,1.6,15.4,0.88,8.6,23,9.7,223,0,5
DeAndre Carter,6.3,0,7,3,1,7,0,0,7,7,1,0.1,23,20,195,9.8,0,9,50,2.9,27.9,0.87,8.5,21,9.6,202,0,4
DeAndre Carter,55.6,0,7,1,0,0,0,0,0,0,0,0,2,2,21,10.5,0,1,11,0.3,3,1,10.5,2,10.5,21,0,1
DeAndre Carter,-0.6,26,16,3,0,0,0,0,0,0,0,0,14,11,162,14.7,0,6,46,0.7,10.1,0.786,11.6,11,14.7,162,0,2
DeAndre Carter,0,27,13,0,0,0,0,0,0,0,0,0,2,1,8,8,0,0,8,0.1,0.6,0.5,4,1,8,8,0,2
DeAndre Carter,1.4,0,4,0,0,0,0,0,0,0,0,0,0,0,0,0,0,0,0,0,0,0,0,0,0,0,0,1
DeAndre Carter,151.5,0,9,0,0,0,0,0,0,0,0,0,2,1,8,8,0,0,8,0.1,0.9,0.5,4,1,8,8,0,1
DeAndre Carter,214.9,28,17,6,10,89,0,4,27,8.9,5.2,0.6,44,24,296,12.3,3,17,26,1.4,17.4,0.545,6.7,34,11.3,385,3,3
DeAndre Carter,124.4,23,15,11,1,9,0,1,9,9,0.6,0.1,50,28,388,13.9,2,15,49,1.9,25.9,0.56,7.8,29,13.7,397,2,0
Dawson Knox,280.3,24,12,7,0,0,0,0,0,0,0,0,44,24,288,12,3,14,36,2,24,0.545,6.5,24,12,288,3,2
Dawson Knox,239.1,25,15,14,0,4,0,0,0,0,0.3,0,71,49,587,12,9,31,53,3.3,39.1,0.69,8.3,49,12.1,591,9,0
Dawson Knox,14.7,21,2,0,0,0,0,0,0,0,0,0,0,0,0,0,0,0,0,0,0,0,0,0,0,0,0,1
Greg Dortch,215.3,23,5,2,1,24,0,1,24,24,4.8,0.2,3,3,15,5,0,0,10,0.6,3,1,5,4,9.8,39,0,0
Greg Dortch,357.8,22,16,6,10,16,2,4,8,1.6,1,0.6,109,62,873,14.1,9,41,84,3.9,54.6,0.569,8,72,12.3,889,11,3
Chase Claypool,203,23,15,13,14,96,0,7,25,6.9,6.4,0.9,105,59,860,14.6,2,35,59,3.9,57.3,0.562,8.2,73,13.1,956,2,0
Chase Claypool,242.7,22,15,10,0,0,0,0,0,0,0,0,53,36,478,13.3,8,30,59,2.4,31.9,0.679,9,36,13.3,478,8,1
Hunter Henry,0,23,14,13,0,0,0,0,0,0,0,0,62,45,579,12.9,4,32,34,3.2,41.4,0.726,9.3,45,12.9,579,4,0
Hunter Henry,278.6,24,0,0,0,0,0,0,0,0,0,0,0,0,0,0,0,0,0,0,0,0,0,0,0,0,0,0
Hunter Henry,267.9,25,12,12,0,0,0,0,0,0,0,0,76,55,652,11.9,5,36,30,4.6,54.3,0.724,8.6,55,11.9,652,5,1
Hunter Henry,284.9,26,14,14,0,0,0,0,0,0,0,0,93,60,613,10.2,4,35,33,4.3,43.8,0.645,6.6,60,10.2,613,4,0
Hunter Henry,205.7,27,17,10,0,0,0,0,0,0,0,0,75,50,603,12.1,9,34,35,2.9,35.5,0.667,8,50,12.1,603,9,0
Hunter Henry,84.7,24,7,4,0,0,0,0,0,0,0,0,10,4,39,9.8,0,3,19,0.6,5.6,0.4,3.9,4,9.8,39,0,0
Juwan Johnson,236.4,25,14,2,0,0,0,0,0,0,0,0,22,13,159,12.2,4,12,27,0.9,11.4,0.591,7.2,13,12.2,159,4,0
Juwan Johnson,429.4,22,11,0,0,0,0,0,0,0,0,0,32,14,174,12.4,0,6,38,1.3,15.8,0.438,5.4,14,12.4,174,0,1
DJ Chark,294.8,23,15,14,2,20,0,1,20,10,1.3,0.1,118,73,1008,13.8,8,42,69,4.9,67.2,0.619,8.5,75,13.7,1028,8,0
DJ Chark,65.2,24,13,12,0,0,0,0,0,0,0,0,93,53,706,13.3,5,37,73,4.1,54.3,0.57,7.6,53,13.3,706,5,0
DJ Chark,198.6,25,4,4,0,0,0,0,0,0,0,0,22,7,154,22,2,7,41,1.8,38.5,0.318,7,7,22,154,2,0
DJ Chark,173.4,26,16,6,0,0,0,0,0,0,0,0,25,17,225,13.2,0,11,28,1.1,14.1,0.68,9,17,13.2,225,0,0
Jordan Akins,165.1,27,16,9,0,0,0,0,0,0,0,0,55,36,418,11.6,2,21,53,2.3,26.1,0.655,7.6,36,11.6,418,2,0
Jordan Akins,85.1,28,13,5,1,4,0,1,4,4,0.3,0.1,49,37,403,10.9,1,20,26,2.8,31,0.755,8.2,38,10.7,407,1,0
Jordan Akins,213.5,29,13,3,1,3,0,1,3,3,0.2,0.1,33,24,214,8.9,0,11,31,1.8,16.5,0.727,6.5,25,8.7,217,0,2
Jordan Akins,437.1,23,16,9,4,20,0,1,16,5,1.3,0.3,98,61,631,10.3,4,33,53,3.8,39.4,0.622,6.4,65,10,651,4,1
Darnell Mooney,200.5,24,17,14,6,32,1,2,15,5.3,1.9,0.4,140,81,1055,13,4,49,64,4.8,62.1,0.579,7.5,87,12.5,1087,5,0
Darnell Mooney,211.6,23,13,0,112,481,4,30,31,4.3,37,8.6,18,14,95,6.8,1,5,20,1.1,7.3,0.778,5.3,126,4.6,576,5,0
Zack Moss,163.5,24,13,0,96,345,4,22,17,3.6,26.5,7.4,32,23,197,8.6,1,12,24,1.8,15.2,0.719,6.2,119,4.6,542,5,2
Zack Moss,139.6,23,16,3,4,70,0,3,42,17.5,4.4,0.3,26,20,201,10.1,0,8,39,1.3,12.6,0.769,7.7,24,11.3,271,0,0
Devin Duvernay,206.3,24,16,7,7,50,0,4,19,7.1,3.1,0.4,47,33,272,8.2,2,14,21,2.1,17,0.702,5.8,40,8.1,322,2,1
Devin Duvernay,281.9,22,16,11,3,-12,0,0,-2,-4,-0.8,0.2,66,40,562,14.1,3,23,75,2.5,35.1,0.606,8.5,43,12.8,550,3,1
Noah Fant,293,23,15,14,0,0,0,0,0,0,0,0,93,62,673,10.9,3,34,37,4.1,44.9,0.667,7.2,62,10.9,673,3,0
Noah Fant,219.8,24,16,16,0,0,0,0,0,0,0,0,90,68,670,9.9,4,29,35,4.3,41.9,0.756,7.4,68,9.9,670,4,0
Noah Fant,182,22,16,1,0,0,0,0,0,0,0,0,24,11,104,9.5,1,8,28,0.7,6.5,0.458,4.3,11,9.5,104,1,0
Josh Reynolds,131.7,23,16,8,2,8,0,1,10,4,0.5,0.1,53,29,402,13.9,5,23,33,1.8,25.1,0.547,7.6,31,13.2,410,5,0
Josh Reynolds,246.9,24,16,2,5,23,0,2,12,4.6,1.4,0.3,43,21,326,15.5,1,15,31,1.3,20.4,0.488,7.6,26,13.4,349,1,0
Josh Reynolds,159.8,25,16,13,1,5,0,0,5,5,0.3,0.1,81,52,618,11.9,2,31,40,3.3,38.6,0.642,7.6,53,11.8,623,2,2
Josh Reynolds,122.8,26,12,5,0,0,0,0,0,0,0,0,49,29,396,13.7,2,21,39,2.4,33,0.592,8.1,29,13.7,396,2,0
Josh Reynolds,37,0,7,5,0,0,0,0,0,0,0,0,36,19,306,16.1,2,15,39,2.7,43.7,0.528,8.5,19,16.1,306,2,0
Josh Reynolds,199.7,0,5,0,0,0,0,0,0,0,0,0,13,10,90,9,0,6,12,2,18,0.769,6.9,10,9,90,0,0
Josh Reynolds,99.5,22,11,0,1,4,0,0,4,4,0.4,0.1,13,4,29,7.3,0,2,14,0.4,2.6,0.308,2.2,5,6.6,33,0,6
Isaiah McKenzie,99.5,23,8,1,10,66,2,4,15,6.6,8.3,1.3,30,18,179,9.9,0,10,23,2.3,22.4,0.6,6,28,8.8,245,2,2
Isaiah McKenzie,0,0,7,1,10,66,2,4,15,6.6,9.4,1.4,30,18,179,9.9,0,10,23,2.6,25.6,0.6,6,28,8.8,245,2,2
Isaiah McKenzie,123.9,0,1,0,0,0,0,0,0,0,0,0,0,0,0,0,0,0,0,0,0,0,0,0,0,0,0,0
Isaiah McKenzie,147.3,24,15,8,8,49,0,4,16,6.1,3.3,0.5,39,27,254,9.4,1,12,46,1.8,16.9,0.692,6.5,35,8.7,303,1,0
Isaiah McKenzie,95.5,25,16,7,10,9,0,2,14,0.9,0.6,0.6,34,30,282,9.4,5,17,46,1.9,17.6,0.882,8.3,40,7.3,291,5,0
Isaiah McKenzie,215.4,26,15,2,9,47,1,4,10,5.2,3.1,0.6,26,20,178,8.9,1,13,28,1.3,11.9,0.769,6.8,29,7.8,225,2,2
Isaiah McKenzie,367.7,22,14,14,240,1070,7,54,47,4.5,76.4,17.1,60,49,344,7,3,15,28,3.5,24.6,0.817,5.7,289,4.9,1414,10,3
James Robinson,181.8,23,14,13,164,767,8,41,58,4.7,54.8,11.7,46,31,222,7.2,0,9,26,2.2,15.9,0.674,4.8,195,5.1,989,8,4
James Robinson,210.1,22,11,0,0,0,0,0,0,0,0,0,34,16,257,16.1,0,12,54,1.5,23.4,0.471,7.6,16,16.1,257,0,0
Kendrick Bourne,167.4,23,16,8,0,0,0,0,0,0,0,0,66,42,487,11.6,4,30,33,2.6,30.4,0.636,7.4,42,11.6,487,4,1
Kendrick Bourne,261.1,24,16,0,0,0,0,0,0,0,0,0,44,30,358,11.9,5,23,30,1.9,22.4,0.682,8.1,30,11.9,358,5,0
Kendrick Bourne,360.5,25,15,5,0,0,0,0,0,0,0,0,74,49,667,13.6,2,35,49,3.3,44.5,0.662,9,49,13.6,667,2,0
Kendrick Bourne,178.9,26,17,5,12,125,0,7,18,10.4,7.4,0.7,70,55,800,14.5,5,27,75,3.2,47.1,0.786,11.4,67,13.8,925,5,1
Kendrick Bourne,46,24,16,1,0,0,0,0,0,0,0,0,6,4,77,19.3,1,3,54,0.3,4.8,0.667,12.8,4,19.3,77,1,0
Robert Tonyan,293.8,25,11,1,0,0,0,0,0,0,0,0,15,10,100,10,1,4,28,0.9,9.1,0.667,6.7,10,10,100,1,0
Robert Tonyan,91.2,26,16,8,0,0,0,0,0,0,0,0,59,52,586,11.3,11,33,45,3.3,36.6,0.881,9.9,52,11.3,586,11,0
Robert Tonyan,206,27,8,5,0,0,0,0,0,0,0,0,29,18,204,11.3,2,10,33,2.3,25.5,0.621,7,18,11.3,204,2,0
Robert Tonyan,84.6,22,16,0,0,0,0,0,0,0,0,0,0,0,0,0,0,0,0,0,0,0,0,0,0,0,0,0
Demarcus Robinson,132.4,23,16,8,0,0,0,0,0,0,0,0,39,21,212,10.1,0,12,33,1.3,13.3,0.538,5.4,21,10.1,212,0,0
Demarcus Robinson,190.7,24,16,5,0,0,0,0,0,0,0,0,33,22,288,13.1,4,12,89,1.4,18,0.667,8.7,22,13.1,288,4,0
Demarcus Robinson,198.8,25,16,10,0,0,0,0,0,0,0,0,55,32,449,14,4,19,44,2,28.1,0.582,8.2,32,14,449,4,0
Demarcus Robinson,122.2,26,16,9,0,0,0,0,0,0,0,0,59,45,466,10.4,3,26,28,2.8,29.1,0.763,7.9,45,10.4,466,3,2
Demarcus Robinson,193.4,27,17,10,0,0,0,0,0,0,0,0,41,25,264,10.6,3,13,33,1.5,15.5,0.61,6.4,25,10.6,264,3,0
Demarcus Robinson,244.8,21,13,13,181,803,4,39,31,4.4,61.8,13.9,54,36,297,8.3,1,12,26,2.8,22.8,0.667,5.5,217,5.1,1100,5,0
Clyde Edwards-Helaire,188.9,22,10,10,119,517,4,21,17,4.3,51.7,11.9,23,19,129,6.8,2,8,29,1.9,12.9,0.826,5.6,138,4.7,646,6,2
Clyde Edwards-Helaire,224.8,22,14,3,0,0,0,0,0,0,0,0,27,19,271,14.3,3,16,44,1.4,19.4,0.704,10,19,14.3,271,3,0
Austin Hooper,293,23,16,8,0,0,0,0,0,0,0,0,65,49,526,10.7,3,18,88,3.1,32.9,0.754,8.1,49,10.7,526,3,0
Austin Hooper,347.1,24,16,7,0,0,0,0,0,0,0,0,88,71,660,9.3,4,30,36,4.4,41.3,0.807,7.5,71,9.3,660,4,0
Austin Hooper,200.5,25,13,10,0,0,0,0,0,0,0,0,97,75,787,10.5,6,41,35,5.8,60.5,0.773,8.1,75,10.5,787,6,0
Austin Hooper,159.5,26,13,13,0,0,0,0,0,0,0,0,70,46,435,9.5,4,27,36,3.5,33.5,0.657,6.2,46,9.5,435,4,0
Austin Hooper,186.2,27,16,16,0,0,0,0,0,0,0,0,61,38,345,9.1,3,18,34,2.4,21.6,0.623,5.7,38,9.1,345,3,0
Austin Hooper,241.8,23,11,6,137,718,2,37,43,5.2,65.3,12.5,2,2,20,10,0,1,13,0.2,1.8,1,10,139,5.3,738,2,0
Gus Edwards,298.6,24,16,1,133,711,2,46,63,5.3,44.4,8.3,7,7,45,6.4,0,2,10,0.4,2.8,1,6.4,140,5.4,756,2,2
Gus Edwards,145.9,25,16,6,144,723,6,45,36,5,45.2,9,13,9,129,14.3,0,4,34,0.6,8.1,0.692,9.9,153,5.6,852,6,1
Gus Edwards,190.4,22,15,0,0,0,0,0,0,0,0,0,10,6,63,10.5,0,2,22,0.4,4.2,0.6,6.3,6,10.5,63,0,0
Russell Gage,334.5,23,16,4,4,12,0,0,6,3,0.8,0.3,74,49,446,9.1,1,25,19,3.1,27.9,0.662,6,53,8.6,458,1,1
Russell Gage,317,24,16,8,2,9,0,1,11,4.5,0.6,0.1,109,72,786,10.9,4,50,35,4.5,49.1,0.661,7.2,74,10.7,795,4,0
Russell Gage,206.8,25,14,9,0,0,0,0,0,0,0,0,94,66,770,11.7,4,37,49,4.7,55,0.702,8.2,66,11.7,770,4,2
Russell Gage,434.1,22,16,8,0,0,0,0,0,0,0,0,68,33,507,15.4,2,21,49,2.1,31.7,0.485,7.5,33,15.4,507,2,0
Michael Gallup,341.9,23,14,12,0,0,0,0,0,0,0,0,113,66,1107,16.8,6,50,62,4.7,79.1,0.584,9.8,66,16.8,1107,6,0
Michael Gallup,180.5,24,16,15,0,0,0,0,0,0,0,0,105,59,843,14.3,5,44,55,3.7,52.7,0.562,8,59,14.3,843,5,0
Michael Gallup,190.2,25,9,8,0,0,0,0,0,0,0,0,62,35,445,12.7,2,23,41,3.9,49.4,0.565,7.2,35,12.7,445,2,0
Michael Gallup,61,22,13,7,0,0,0,0,0,0,0,0,25,21,174,8.3,5,14,23,1.6,13.4,0.84,7,21,8.3,174,5,0
Foster Moreau,157.9,23,16,2,0,0,0,0,0,0,0,0,9,7,140,20,2,5,47,0.4,8.8,0.778,15.6,7,20,140,2,0
Foster Moreau,169.6,24,17,11,0,0,0,0,0,0,0,0,44,30,373,12.4,3,16,44,1.8,21.9,0.682,8.5,30,12.4,373,3,1
Foster Moreau,445.8,21,15,0,2,5,0,0,4,2.5,0.3,0.1,31,25,375,15,1,15,61,1.7,25,0.806,12.1,27,14.1,380,1,3
Randall Cobb,208.3,22,15,8,10,132,0,7,28,13.2,8.8,0.7,104,80,954,11.9,8,47,39,5.3,63.6,0.769,9.2,90,12.1,1086,8,4
Randall Cobb,554.2,23,6,4,4,78,0,1,67,19.5,13,0.7,47,31,433,14,4,18,48,5.2,72.2,0.66,9.2,35,14.6,511,4,0
Randall Cobb,376.7,24,16,16,11,37,0,1,12,3.4,2.3,0.7,127,91,1287,14.1,12,71,70,5.7,80.4,0.717,10.1,102,13,1324,12,3
Randall Cobb,274.9,25,16,15,13,50,0,3,12,3.8,3.1,0.8,129,79,829,10.5,6,42,53,4.9,51.8,0.612,6.4,92,9.6,879,6,1
Randall Cobb,289,26,13,10,10,33,0,4,14,3.3,2.5,0.8,84,60,610,10.2,4,36,47,4.6,46.9,0.714,7.3,70,9.2,643,4,1
Randall Cobb,160.9,27,15,14,9,17,0,1,10,1.9,1.1,0.6,92,66,653,9.9,4,30,46,4.4,43.5,0.717,7.1,75,8.9,670,4,1
Randall Cobb,320.7,28,9,6,0,0,0,0,0,0,0,0,61,38,383,10.1,2,18,75,4.2,42.6,0.623,6.3,38,10.1,383,2,2
Randall Cobb,188.3,29,15,6,3,11,0,0,7,3.7,0.7,0.2,83,55,828,15.1,3,41,59,3.7,55.2,0.663,10,58,14.5,839,3,2
Randall Cobb,168.8,30,10,2,0,0,0,0,0,0,0,0,48,38,441,11.6,3,20,34,3.8,44.1,0.792,9.2,38,11.6,441,3,0
Randall Cobb,163.1,31,12,3,1,1,0,0,1,1,0.1,0.1,39,28,375,13.4,5,21,54,2.3,31.3,0.718,9.6,29,13,376,5,1
Randall Cobb,28,22,13,2,0,0,0,0,0,0,0,0,28,19,210,11.1,1,11,21,1.5,16.2,0.679,7.5,19,11.1,210,1,0
Trent Sherfield,20,23,16,1,0,0,0,0,0,0,0,0,13,4,80,20,0,4,38,0.3,5,0.308,6.2,4,20,80,0,0
Trent Sherfield,41.1,24,15,1,0,0,0,0,0,0,0,0,7,5,50,10,0,2,26,0.3,3.3,0.714,7.1,5,10,50,0,0
Trent Sherfield,167.1,25,17,1,0,0,0,0,0,0,0,0,20,9,87,9.7,1,7,18,0.5,5.1,0.45,4.4,9,9.7,87,1,0
Trent Sherfield,146.7,25,12,0,1,0,0,0,0,0,0,0.1,23,13,163,12.5,1,8,32,1.1,13.6,0.565,7.1,14,11.6,163,1,0
Hayden Hurst,263.3,26,16,4,0,0,0,0,0,0,0,0,39,30,349,11.6,2,16,61,1.9,21.8,0.769,8.9,30,11.6,349,2,0
Hayden Hurst,104.3,27,16,9,0,0,0,0,0,0,0,0,88,56,571,10.2,6,35,42,3.5,35.7,0.636,6.5,56,10.2,571,6,0
Hayden Hurst,188.2,28,13,5,0,0,0,0,0,0,0,0,31,26,221,8.5,3,11,33,2,17,0.839,7.1,26,8.5,221,3,3
Hayden Hurst,284.6,23,16,3,0,0,0,0,0,0,0,0,57,36,469,13,4,25,38,2.3,29.3,0.632,8.2,36,13,469,4,0
Zach Ertz,340.9,24,16,5,0,0,0,0,0,0,0,0,89,58,702,12.1,3,42,35,3.6,43.9,0.652,7.9,58,12.1,702,3,1
Zach Ertz,346.8,25,15,7,0,0,0,0,0,0,0,0,112,75,853,11.4,2,40,60,5,56.9,0.67,7.6,75,11.4,853,2,1
Zach Ertz,367.2,26,14,12,0,0,0,0,0,0,0,0,106,78,816,10.5,4,42,30,5.6,58.3,0.736,7.7,78,10.5,816,4,0
Zach Ertz,510.9,27,14,13,0,0,0,0,0,0,0,0,110,74,824,11.1,8,46,53,5.3,58.9,0.673,7.5,74,11.1,824,8,1
Zach Ertz,396.8,28,16,16,0,0,0,0,0,0,0,0,156,116,1163,10,8,66,34,7.3,72.7,0.744,7.5,116,10,1163,8,1
Zach Ertz,142.5,29,15,15,0,0,0,0,0,0,0,0,135,88,916,10.4,6,50,30,5.9,61.1,0.652,6.8,88,10.4,916,6,1
Zach Ertz,334.1,30,11,11,0,0,0,0,0,0,0,0,72,36,335,9.3,1,16,42,3.3,30.5,0.5,4.7,36,9.3,335,1,0
Zach Ertz,247.4,31,17,14,1,4,0,0,4,4,0.2,0.1,112,74,763,10.3,5,40,47,4.4,44.9,0.661,6.8,75,10.2,767,5,0
Zach Ertz,86.7,0,11,11,1,4,0,0,4,4,0.4,0.1,81,56,574,10.3,3,30,47,5.1,52.2,0.691,7.1,57,10.1,578,3,0
Zach Ertz,192.8,0,6,3,0,0,0,0,0,0,0,0,31,18,189,10.5,2,10,28,3,31.5,0.581,6.1,18,10.5,189,2,0
Zach Ertz,164.4,22,16,0,60,208,2,14,29,3.5,13,3.8,23,20,103,5.2,0,5,13,1.3,6.4,0.87,4.5,80,3.9,311,2,1
Chase Edmonds,334,23,13,2,60,303,4,12,37,5.1,23.3,4.6,21,12,105,8.8,1,5,31,0.9,8.1,0.571,5,72,5.7,408,5,0
Chase Edmonds,323.9,24,16,2,97,448,1,22,32,4.6,28,6.1,67,53,402,7.6,4,21,30,3.3,25.1,0.791,6,150,5.7,850,5,2
Chase Edmonds,154.6,25,12,11,116,592,2,32,54,5.1,49.3,9.7,53,43,311,7.2,0,11,36,3.6,25.9,0.811,5.9,159,5.7,903,2,1
Chase Edmonds,202.8,23,14,1,0,0,0,0,0,0,0,0,8,3,33,11,0,3,19,0.2,2.4,0.375,4.1,3,11,33,0,0
Nick Westbrook-Ikhine,162.1,24,16,7,0,0,0,0,0,0,0,0,57,38,476,12.5,4,23,46,2.4,29.8,0.667,8.4,38,12.5,476,4,1
Nick Westbrook-Ikhine,14,23,12,1,3,13,0,1,17,4.3,1.1,0.3,32,17,283,16.6,3,13,59,1.4,23.6,0.531,8.8,20,14.8,296,3,1
Marquise Goodwin,9.2,24,10,0,3,8,0,1,12,2.7,0.8,0.3,9,1,42,42,0,1,42,0.1,4.2,0.111,4.7,4,12.5,50,0,1
Marquise Goodwin,176.3,25,2,0,0,0,0,0,0,0,0,0,2,2,24,12,0,2,14,1,12,1,12,2,12,24,0,0
Marquise Goodwin,369.8,26,15,9,0,0,0,0,0,0,0,0,68,29,431,14.9,3,20,84,1.9,28.7,0.426,6.3,29,14.9,431,3,0
Marquise Goodwin,166.2,27,16,16,4,44,0,3,18,11,2.8,0.3,105,56,962,17.2,2,46,83,3.5,60.1,0.533,9.2,60,16.8,1006,2,0
Marquise Goodwin,78.3,28,11,8,4,9,0,0,5,2.3,0.8,0.4,43,23,395,17.2,4,19,67,2.1,35.9,0.535,9.2,27,15,404,4,1
Marquise Goodwin,117.6,29,9,6,1,15,0,1,15,15,1.7,0.1,21,12,186,15.5,1,10,38,1.3,20.7,0.571,8.9,13,15.5,201,1,0
Marquise Goodwin,168.6,31,14,2,2,-1,0,0,1,-0.5,-0.1,0.1,40,20,313,15.7,1,12,50,1.4,22.4,0.5,7.8,22,14.2,312,1,1
Marquise Goodwin,176.6,23,1,0,0,0,0,0,0,0,0,0,0,0,0,0,0,0,0,0,0,0,0,0,0,0,0,0
Isaiah Hodgins,45,23,14,0,111,354,2,20,33,3.2,25.3,7.9,23,23,148,6.4,0,9,35,1.6,10.6,1,6.4,134,3.7,502,2,2
Joshua Kelley,142.4,24,10,0,33,102,0,5,14,3.1,10.2,3.3,6,5,38,7.6,0,1,17,0.5,3.8,0.833,6.3,38,3.7,140,0,1
Joshua Kelley,47.5,23,6,1,0,0,0,0,0,0,0,0,6,2,18,9,0,1,17,0.3,3,0.333,3,2,9,18,0,0
Darren Waller,34.8,24,12,3,0,0,0,0,0,0,0,0,17,10,85,8.5,2,7,15,0.8,7.1,0.588,5,10,8.5,85,2,0
Darren Waller,451,26,4,0,1,21,0,1,21,21,5.3,0.3,6,6,75,12.5,0,4,44,1.5,18.8,1,12.5,7,13.7,96,0,0
Darren Waller,515.8,27,16,16,2,5,0,0,7,2.5,0.3,0.1,117,90,1145,12.7,3,53,75,5.6,71.6,0.769,9.8,92,12.5,1150,3,1
Darren Waller,266.5,28,16,15,0,0,0,0,0,0,0,0,145,107,1196,11.2,9,68,38,6.7,74.8,0.738,8.2,107,11.2,1196,9,2
Darren Waller,162.4,29,11,11,0,0,0,0,0,0,0,0,93,55,665,12.1,2,31,33,5,60.5,0.591,7.2,55,12.1,665,2,0
Darren Waller,286.9,22,13,0,39,147,0,10,22,3.8,11.3,3,6,4,37,9.3,0,1,14,0.3,2.8,0.667,6.2,43,4.3,184,0,0
Darrell Henderson,336.2,23,15,11,138,624,5,40,40,4.5,41.6,9.2,24,16,159,9.9,1,8,28,1.1,10.6,0.667,6.6,154,5.1,783,6,0
Darrell Henderson,150.5,24,12,10,149,688,5,39,29,4.6,57.3,12.4,40,29,176,6.1,3,8,25,2.4,14.7,0.725,4.4,178,4.9,864,8,0
Darrell Henderson,50.2,22,12,7,1,5,0,0,5,5,0.4,0.1,36,21,328,15.6,0,13,54,1.8,27.3,0.583,9.1,22,15.1,333,0,0
Equanimeous St. Brown,42.6,24,12,1,1,7,0,1,7,7,0.6,0.1,13,7,117,16.7,1,6,24,0.6,9.8,0.538,9,8,15.5,124,1,0
Equanimeous St. Brown,138.1,25,13,2,3,14,0,2,13,4.7,1.1,0.2,17,9,98,10.9,0,6,26,0.7,7.5,0.529,5.8,12,9.3,112,0,0
Equanimeous St. Brown,198.7,21,13,0,100,462,1,19,35,4.6,35.5,7.7,12,10,82,8.2,0,3,17,0.8,6.3,0.833,6.8,110,4.9,544,1,1
Alexander Mattison,269.7,22,13,2,96,434,2,24,25,4.5,33.4,7.4,15,13,125,9.6,1,5,28,1,9.6,0.867,8.3,109,5.1,559,3,0
Alexander Mattison,163.2,23,16,4,134,491,3,28,48,3.7,30.7,8.4,39,32,228,7.1,1,10,24,2,14.3,0.821,5.8,166,4.3,719,4,1
Alexander Mattison,332.6,24,16,0,1,-1,0,0,-1,-1,-0.1,0.1,31,19,220,11.6,1,11,31,1.2,13.8,0.613,7.1,20,11,219,1,1
Van Jefferson,152.7,25,17,17,2,20,0,1,10,10,1.2,0.1,89,50,802,16,6,32,79,2.9,47.2,0.562,9,52,15.8,822,6,0
Van Jefferson,159.7,22,13,12,0,0,0,0,0,0,0,0,44,23,283,12.3,1,11,53,1.8,21.8,0.523,6.4,23,12.3,283,1,1
Nelson Agholor,342.5,23,15,14,5,14,0,0,5,2.8,0.9,0.3,69,36,365,10.1,2,15,40,2.4,24.3,0.522,5.3,41,9.2,379,2,1
Nelson Agholor,316.4,24,16,10,1,7,0,1,7,7,0.4,0.1,95,62,768,12.4,8,35,72,3.9,48,0.653,8.1,63,12.3,775,8,0
Nelson Agholor,164,25,16,16,3,32,0,2,16,10.7,2,0.2,97,64,736,11.5,4,28,83,4,46,0.66,7.6,67,11.5,768,4,1
Nelson Agholor,364.8,26,11,10,2,7,0,1,16,3.5,0.6,0.2,69,39,363,9.3,3,17,43,3.5,33,0.565,5.3,41,9,370,3,2
Nelson Agholor,200.2,27,16,13,0,0,0,0,0,0,0,0,82,48,896,18.7,8,37,85,3,56,0.585,10.9,48,18.7,896,8,0
Nelson Agholor,147.6,28,15,13,3,11,0,0,6,3.7,0.7,0.2,64,37,473,12.8,3,23,44,2.5,31.5,0.578,7.4,40,12.1,484,3,0
Nelson Agholor,250,23,16,7,0,0,0,0,0,0,0,0,32,22,202,9.2,0,9,27,1.4,12.6,0.688,6.3,22,9.2,202,0,1
Mike Gesicki,299.9,24,16,5,0,0,0,0,0,0,0,0,89,51,570,11.2,5,25,34,3.2,35.6,0.573,6.4,51,11.2,570,5,1
Mike Gesicki,319,25,15,9,0,0,0,0,0,0,0,0,85,53,703,13.3,6,36,70,3.5,46.9,0.624,8.3,53,13.3,703,6,0
Mike Gesicki,170.6,26,17,9,0,0,0,0,0,0,0,0,112,73,780,10.7,2,39,40,4.3,45.9,0.652,7,73,10.7,780,2,0
Mike Gesicki,165.9,22,14,0,85,419,2,18,38,4.9,29.9,6.1,12,9,75,8.3,0,3,24,0.6,5.4,0.75,6.3,94,5.3,494,2,0
Rashaad Penny,0,23,10,0,65,370,3,16,58,5.7,37,6.5,11,8,83,10.4,1,3,30,0.8,8.3,0.727,7.5,73,6.2,453,4,1
Rashaad Penny,281.1,24,3,0,11,34,0,1,7,3.1,11.3,3.7,0,0,0,0,0,0,0,0,0,0,0,11,3.1,34,0,0
Rashaad Penny,122.6,25,10,6,119,749,6,28,62,6.3,74.9,11.9,8,6,48,8,0,3,27,0.6,4.8,0.75,6,125,6.4,797,6,0
Rashaad Penny,244,22,6,0,0,0,0,0,0,0,0,0,13,7,106,15.1,1,4,43,1.2,17.7,0.538,8.2,7,15.1,106,1,0
Quez Watkins,155.5,23,17,12,1,3,0,0,3,3,0.2,0.1,62,43,647,15,1,25,91,2.5,38.1,0.694,10.4,44,14.8,650,1,0
Quez Watkins,125.7,22,4,4,0,0,0,0,0,0,0,0,14,8,156,19.5,2,5,66,2,39,0.571,11.1,8,19.5,156,2,0
Will Dissly,111.3,23,6,6,1,7,0,0,7,7,1.2,0.2,27,23,262,11.4,4,14,38,3.8,43.7,0.852,9.7,24,11.2,269,4,1
Will Dissly,94.3,24,16,12,0,0,0,0,0,0,0,0,29,24,251,10.5,2,12,28,1.5,15.7,0.828,8.7,24,10.5,251,2,0
Will Dissly,156.7,25,15,14,0,0,0,0,0,0,0,0,26,21,231,11,1,11,39,1.4,15.4,0.808,8.9,21,11,231,1,1
Will Dissly,507.4,22,13,13,6,56,0,4,19,9.3,4.3,0.5,95,54,959,17.8,8,36,80,4.2,73.8,0.568,10.1,60,16.9,1015,8,1
Julio Jones,225.1,23,16,15,6,30,0,3,18,5,1.9,0.4,128,79,1198,15.2,10,56,80,4.9,74.9,0.617,9.4,85,14.4,1228,10,0
Julio Jones,614.2,24,5,5,1,7,0,1,7,7,1.4,0.2,59,41,580,14.1,2,25,81,8.2,116,0.695,9.8,42,14,587,2,2
Julio Jones,739.3,25,15,15,1,1,0,1,1,1,0.1,0.1,163,104,1593,15.3,6,76,79,6.9,106.2,0.638,9.8,105,15.2,1594,6,2
Julio Jones,541.7,26,16,16,0,0,0,0,0,0,0,0,203,136,1871,13.8,8,93,70,8.5,116.9,0.67,9.2,136,13.8,1871,8,3
Julio Jones,543.7,27,14,14,0,0,0,0,0,0,0,0,129,83,1409,17,6,64,75,5.9,100.6,0.643,10.9,83,17,1409,6,0
Julio Jones,663.7,28,16,16,1,15,0,1,15,15,0.9,0.1,148,88,1444,16.4,3,67,53,5.5,90.3,0.595,9.8,89,16.4,1459,3,0
Julio Jones,550.3,29,16,16,2,12,0,1,11,6,0.8,0.1,170,113,1677,14.8,8,80,58,7.1,104.8,0.665,9.9,115,14.7,1689,8,2
Julio Jones,300.3,30,15,15,2,-3,0,0,1,-1.5,-0.2,0.1,157,99,1394,14.1,6,77,54,6.6,92.9,0.631,8.9,101,13.8,1391,6,1
Julio Jones,167.2,31,9,9,0,0,0,0,0,0,0,0,68,51,771,15.1,3,36,44,5.7,85.7,0.75,11.3,51,15.1,771,3,0
Julio Jones,139.2,32,10,10,0,0,0,0,0,0,0,0,48,31,434,14,1,19,51,3.1,43.4,0.646,9,31,14,434,1,0
Julio Jones,584,21,10,8,0,0,0,0,0,0,0,0,81,48,548,11.4,2,26,54,4.8,54.8,0.593,6.8,48,11.4,548,2,0
Allen Robinson,371.9,22,16,16,0,0,0,0,0,0,0,0,151,80,1400,17.5,14,61,90,5,87.5,0.53,9.3,80,17.5,1400,14,0
Allen Robinson,6.1,23,16,16,0,0,0,0,0,0,0,0,151,73,883,12.1,6,51,42,4.6,55.2,0.483,5.8,73,12.1,883,6,1
Allen Robinson,305.9,24,1,1,0,0,0,0,0,0,0,0,1,1,17,17,0,1,17,1,17,1,17,1,17,17,0,0
Allen Robinson,484.7,25,13,12,1,9,0,0,9,9,0.7,0.1,94,55,754,13.7,4,36,43,4.2,58,0.585,8,56,13.6,763,4,1
Allen Robinson,512.7,26,16,15,1,2,0,0,2,2,0.1,0.1,154,98,1147,11.7,7,63,49,6.1,71.7,0.636,7.4,99,11.6,1149,7,0
Allen Robinson,167,27,16,16,1,-1,0,0,-1,-1,-0.1,0.1,151,102,1250,12.3,6,68,42,6.4,78.1,0.675,8.3,103,12.1,1249,6,0
Allen Robinson,152.7,28,12,11,0,0,0,0,0,0,0,0,66,38,410,10.8,1,22,39,3.2,34.2,0.576,6.2,38,10.8,410,1,0
Allen Robinson,377.5,22,16,0,105,465,2,23,33,4.4,29.1,6.6,36,21,180,8.6,1,9,32,1.3,11.3,0.583,5,126,5.1,645,3,1
Matt Breida,249.9,23,14,13,153,814,3,36,66,5.3,58.1,10.9,31,27,261,9.7,2,12,26,1.9,18.6,0.871,8.4,180,6,1075,5,1
Matt Breida,110,24,13,5,123,623,1,23,83,5.1,47.9,9.5,22,19,120,6.3,1,6,17,1.5,9.2,0.864,5.5,142,5.2,743,2,2
Matt Breida,82.1,25,12,1,59,254,0,11,24,4.3,21.2,4.9,10,9,96,10.7,0,5,31,0.8,8,0.9,9.6,68,5.1,350,0,2
Matt Breida,127.4,26,9,0,26,125,1,5,28,4.8,13.9,2.9,9,7,72,10.3,2,4,23,0.8,8,0.778,8,33,6,197,3,1
Matt Breida,259,22,14,12,18,91,0,6,17,5.1,6.5,1.3,79,58,600,10.3,5,33,36,4.1,42.9,0.734,7.6,76,9.1,691,5,0
Laviska Shenault Jr.,140.1,23,16,10,11,41,0,2,11,3.7,2.6,0.7,100,63,619,9.8,0,30,58,3.9,38.7,0.63,6.2,74,8.9,660,0,1
Laviska Shenault Jr.,260.8,24,13,4,0,0,0,0,0,0,0,0,71,49,605,12.3,4,30,65,3.8,46.5,0.69,8.5,49,12.3,605,4,1
Hunter Renfrow,459.3,25,16,6,0,0,0,0,0,0,0,0,77,56,656,11.7,2,32,53,3.5,41,0.727,8.5,56,11.7,656,2,2
Hunter Renfrow,141,26,17,9,3,3,0,0,5,1,0.2,0.2,128,103,1038,10.1,9,51,54,6.1,61.1,0.805,8.1,106,9.8,1041,9,5
Hunter Renfrow,238.3,21,16,5,4,17,0,1,9,4.3,1.1,0.3,41,26,538,20.7,6,18,83,1.6,33.6,0.634,13.1,30,18.5,555,6,2
Mecole Hardman,286.7,22,16,8,4,31,0,2,20,7.8,1.9,0.3,62,41,560,13.7,4,23,49,2.6,35,0.661,9,45,13.1,591,4,2
Mecole Hardman,157.4,23,17,8,8,46,0,2,24,5.8,2.7,0.5,83,59,693,11.7,2,33,53,3.5,40.8,0.711,8.3,67,11,739,2,3
Mecole Hardman,73.5,23,1,0,2,7,0,0,5,3.5,7,2,0,0,0,0,0,0,0,0,0,0,0,2,3.5,7,0,0
Kendall Hinton,121.2,24,16,1,0,0,0,0,0,0,0,0,23,15,175,11.7,1,10,40,0.9,10.9,0.652,7.6,15,11.7,175,1,0
Kendall Hinton,33.1,23,2,0,0,0,0,0,0,0,0,0,0,0,0,0,0,0,0,0,0,0,0,0,0,0,0,0
Logan Thomas,35.1,26,12,2,0,0,0,0,0,0,0,0,9,7,67,9.6,1,2,22,0.6,5.6,0.778,7.4,7,9.6,67,1,0
Logan Thomas,73.9,27,12,3,0,0,0,0,0,0,0,0,17,12,77,6.4,0,3,24,1,6.4,0.706,4.5,12,6.4,77,0,0
Logan Thomas,310.5,28,16,3,0,0,0,0,0,0,0,0,28,16,173,10.8,1,10,17,1,10.8,0.571,6.2,16,10.8,173,1,0
Logan Thomas,92.8,29,16,15,3,5,0,2,3,1.7,0.3,0.2,110,72,670,9.3,6,36,30,4.5,41.9,0.655,6.1,75,9,675,6,0
Logan Thomas,141.9,30,6,6,0,0,0,0,0,0,0,0,25,18,196,10.9,3,10,35,3,32.7,0.72,7.8,18,10.9,196,3,1
Logan Thomas,62.3,23,11,0,0,0,0,0,0,0,0,0,10,9,105,11.7,0,4,24,0.8,9.5,0.9,10.5,9,11.7,105,0,0
Dontrell Hilliard,16,24,14,0,13,49,2,3,11,3.8,3.5,0.9,15,12,92,7.7,0,4,19,0.9,6.6,0.8,6.1,25,5.6,141,2,2
Dontrell Hilliard,16,25,7,0,9,48,0,3,19,5.3,6.9,1.3,1,1,2,2,0,0,2,0.1,0.3,1,2,10,5,50,0,0
Dontrell Hilliard,0,0,5,0,9,48,0,3,19,5.3,9.6,1.8,1,1,2,2,0,0,2,0.2,0.4,1,2,10,5,50,0,0
Dontrell Hilliard,158.1,0,2,0,0,0,0,0,0,0,0,0,0,0,0,0,0,0,0,0,0,0,0,0,0,0,0,0
Dontrell Hilliard,141.6,26,8,5,56,350,2,15,68,6.3,43.8,7,26,19,87,4.6,0,7,28,2.4,10.9,0.731,3.3,75,5.8,437,2,2
Dontrell Hilliard,14.9,21,6,0,0,0,0,0,0,0,0,0,2,2,16,8,0,2,10,0.3,2.7,1,8,2,8,16,0,0
Colby Parkinson,133.6,22,14,1,0,0,0,0,0,0,0,0,8,5,33,6.6,0,2,12,0.4,2.4,0.625,4.1,5,6.6,33,0,0
Colby Parkinson,92.5,24,8,0,39,148,1,7,20,3.8,18.5,4.9,8,7,33,4.7,0,0,16,0.9,4.1,0.875,4.1,46,3.9,181,1,1
Jamycal Hasty,134,25,11,0,16,68,1,6,21,4.3,6.2,1.5,29,23,157,6.8,0,7,23,2.1,14.3,0.793,5.4,39,5.8,225,1,2
Jamycal Hasty,29,22,16,0,58,225,2,10,18,3.9,14.1,3.6,15,8,70,8.8,0,5,14,0.5,4.4,0.533,4.7,66,4.5,295,2,0
Justice Hill,104,23,12,0,12,60,0,2,19,5,5,1,5,5,20,4,0,0,8,0.4,1.7,1,4,17,4.7,80,0,0
Justice Hill,74.7,22,12,0,0,0,0,0,0,0,0,0,3,1,5,5,0,0,5,0.1,0.4,0.333,1.7,1,5,5,0,0
Justin Watson,35.2,23,16,2,0,0,0,0,0,0,0,0,26,15,159,10.6,2,10,17,0.9,9.9,0.577,6.1,15,10.6,159,2,0
Justin Watson,0,24,11,2,0,0,0,0,0,0,0,0,11,7,94,13.4,0,5,36,0.6,8.5,0.636,8.5,7,13.4,94,0,0
Justin Watson,121.5,25,1,0,0,0,0,0,0,0,0,0,0,0,0,0,0,0,0,0,0,0,0,0,0,0,0,0
Justin Watson,112.3,22,12,2,34,108,2,9,13,3.2,9,2.8,20,17,111,6.5,1,5,13,1.4,9.3,0.85,5.6,51,4.3,219,3,0
DeeJay Dallas,108.6,23,17,0,33,138,2,10,15,4.2,8.1,1.9,23,21,133,6.3,0,4,29,1.2,7.8,0.913,5.8,54,5,271,2,1
DeeJay Dallas,225.3,22,10,4,122,474,5,29,35,3.9,47.4,12.2,13,11,46,4.2,0,3,9,1.1,4.6,0.846,3.5,133,3.9,520,5,1
Mark Ingram,149.2,23,16,5,156,602,5,29,31,3.9,37.6,9.8,10,6,29,4.8,0,2,16,0.4,1.8,0.6,2.9,162,3.9,631,5,0
Mark Ingram,409.7,24,11,3,78,386,1,18,34,4.9,35.1,7.1,11,7,68,9.7,0,3,23,0.6,6.2,0.636,6.2,85,5.3,454,1,0
Mark Ingram,434.2,25,13,9,226,964,9,52,31,4.3,74.2,17.4,36,29,145,5,0,5,14,2.2,11.2,0.806,4,255,4.3,1109,9,3
Mark Ingram,510.6,26,12,10,166,769,6,47,70,4.6,64.1,13.8,60,50,405,8.1,0,22,59,4.2,33.8,0.833,6.8,216,5.4,1174,6,2
Mark Ingram,586,27,16,14,205,1043,6,50,75,5.1,65.2,12.8,58,46,319,6.9,4,18,22,2.9,19.9,0.793,5.5,251,5.4,1362,10,2
Mark Ingram,301.5,28,16,12,230,1124,12,52,72,4.9,70.3,14.4,71,58,416,7.2,0,19,54,3.6,26,0.817,5.9,288,5.3,1540,12,3
Mark Ingram,491.5,29,12,6,138,645,6,34,38,4.7,53.8,11.5,27,21,170,8.1,1,5,28,1.8,14.2,0.778,6.3,159,5.1,815,7,3
Mark Ingram,122.7,30,15,15,202,1018,10,53,53,5,67.9,13.5,29,26,247,9.5,5,16,25,1.7,16.5,0.897,8.5,228,5.5,1265,15,2
Mark Ingram,251.8,31,11,9,72,299,2,14,30,4.2,27.2,6.5,8,6,50,8.3,0,2,18,0.5,4.5,0.75,6.3,78,4.5,349,2,0
Mark Ingram,108.4,32,14,10,160,554,2,23,28,3.5,39.6,11.4,35,27,162,6,0,9,34,1.9,11.6,0.771,4.6,187,3.8,716,2,1
Mark Ingram,143.4,0,7,7,92,294,1,14,24,3.2,42,13.1,9,7,24,3.4,0,1,10,1,3.4,0.778,2.7,99,3.2,318,1,0
Mark Ingram,108.3,0,7,3,68,260,1,9,28,3.8,37.1,9.7,26,20,138,6.9,0,8,34,2.9,19.7,0.769,5.3,88,4.5,398,1,1
Mark Ingram,35.8,23,1,0,0,0,0,0,0,0,0,0,0,0,0,0,0,0,0,0,0,0,0,0,0,0,0,0
Rex Burkhead,43.4,24,9,0,9,27,1,1,10,3,3,1,10,7,49,7,0,3,15,0.8,5.4,0.7,4.9,16,4.8,76,1,0
Rex Burkhead,173.7,25,16,0,4,4,0,0,2,1,0.3,0.3,15,10,94,9.4,1,4,27,0.6,5.9,0.667,6.3,14,7,98,1,1
Rex Burkhead,231.4,26,16,1,74,344,2,24,17,4.6,21.5,4.6,20,17,145,8.5,0,9,18,1.1,9.1,0.85,7.3,91,5.4,489,2,1
Rex Burkhead,111.1,27,10,3,64,264,5,14,31,4.1,26.4,6.4,36,30,254,8.5,3,13,23,3,25.4,0.833,7.1,94,5.5,518,8,1
Rex Burkhead,217.3,28,8,4,57,186,0,11,12,3.3,23.3,7.1,20,14,131,9.4,1,4,25,1.8,16.4,0.7,6.6,71,4.5,317,1,2
Rex Burkhead,200.8,29,13,1,65,302,3,18,33,4.6,23.2,5,38,27,279,10.3,0,10,32,2.1,21.5,0.711,7.3,92,6.3,581,3,1
Rex Burkhead,224.9,30,10,0,67,274,3,18,18,4.1,27.4,6.7,33,25,192,7.7,3,11,24,2.5,19.2,0.758,5.8,92,5.1,466,6,0
Rex Burkhead,128.2,31,16,5,122,427,3,30,36,3.5,26.7,7.6,32,25,186,7.4,0,9,20,1.6,11.6,0.781,5.8,147,4.2,613,3,1
Rex Burkhead,390,23,16,8,3,42,0,2,30,14,2.6,0.2,78,42,587,14,2,19,52,2.6,36.7,0.538,7.5,45,14,629,2,1
Chosen Anderson,305.2,24,16,15,3,9,0,0,7,3,0.6,0.2,114,63,941,14.9,7,38,69,3.9,58.8,0.553,8.3,66,14.4,950,7,0
Chosen Anderson,314.9,25,14,9,2,-8,0,0,1,-4,-0.6,0.1,94,50,752,15,6,30,76,3.6,53.7,0.532,8,52,14.3,744,6,2
Chosen Anderson,444.3,26,16,15,1,4,0,0,4,4,0.3,0.1,96,52,779,15,5,35,92,3.3,48.7,0.542,8.1,53,14.8,783,5,1
Chosen Anderson,249.5,27,16,16,4,15,0,1,11,3.8,0.9,0.3,136,95,1096,11.5,3,49,75,5.9,68.5,0.699,8.1,99,11.2,1111,3,1
Chosen Anderson,108.6,28,17,16,3,36,0,1,30,12,2.1,0.2,110,53,519,9.8,5,27,57,3.1,30.5,0.482,4.7,56,9.9,555,5,0
Chosen Anderson,55.7,23,12,7,1,-2,0,0,-2,-2,-0.2,0.1,45,27,467,17.3,5,19,75,2.3,38.9,0.6,10.4,28,16.6,465,5,2
Dante Pettis,30.8,24,11,4,0,0,0,0,0,0,0,0,24,11,109,9.9,2,7,21,1,9.9,0.458,4.5,11,9.9,109,2,0
Dante Pettis,32.8,25,7,1,0,0,0,0,0,0,0,0,6,4,76,19,1,3,33,0.6,10.9,0.667,12.7,4,19,76,1,1
Dante Pettis,0,0,2,0,0,0,0,0,0,0,0,0,5,4,76,19,1,3,33,2,38,0.8,15.2,4,19,76,1,0
Dante Pettis,40.1,0,5,1,0,0,0,0,0,0,0,0,1,0,0,0,0,0,0,0,0,0,0,0,0,0,0,1
Dante Pettis,119.6,26,3,0,0,0,0,0,0,0,0,0,16,10,87,8.7,1,5,27,3.3,29,0.625,5.4,10,8.7,87,1,1
Dante Pettis,118.2,22,15,7,0,0,0,0,0,0,0,0,44,28,427,15.3,5,23,62,1.9,28.5,0.636,9.7,28,15.3,427,5,0
Tre'Quan Smith,191.3,23,11,6,0,0,0,0,0,0,0,0,25,18,234,13,5,17,32,1.6,21.3,0.72,9.4,18,13,234,5,0
Tre'Quan Smith,161.1,24,14,10,1,3,0,0,3,3,0.2,0.1,50,34,448,13.2,4,22,31,2.4,32,0.68,9,35,12.9,451,4,1
Tre'Quan Smith,108.4,25,11,6,0,0,0,0,0,0,0,0,50,32,377,11.8,3,18,34,2.9,34.3,0.64,7.5,32,11.8,377,3,1
Tre'Quan Smith,209.7,22,16,4,85,314,2,17,18,3.7,19.6,5.3,81,63,425,6.7,2,29,28,3.9,26.6,0.778,5.2,148,5,739,4,1
Nyheim Hines,363.6,23,16,2,52,199,2,16,18,3.8,12.4,3.3,58,44,320,7.3,0,15,21,2.8,20,0.759,5.5,96,5.4,519,2,1
Nyheim Hines,227.8,24,16,2,89,380,3,24,31,4.3,23.8,5.6,76,63,482,7.7,4,24,29,3.9,30.1,0.829,6.3,152,5.7,862,7,0
Nyheim Hines,120.2,25,17,4,56,276,2,15,34,4.9,16.2,3.3,57,40,310,7.8,1,15,36,2.4,18.2,0.702,5.4,96,6.1,586,3,3
